8,11,11,7,7,14,0,10,104,36,10,13,18,9,5,22,30,13,16,10,15,69,867,248,39,8,8,12,49,2,10,0,5,12,10,4,8,6,16,8,16,10,20,18,0,13,11,12,2,26,31,12,16,633,22,61,6,8,16,11,16,28,16,0
21,61,13,2,0,11,48,23,32,15,13,35,5,10,2,12,7,23,82,2,8,12,14,0,21,1,12,1,4,6,0,3,7,7,2,10,4,2,6,12,15,2,11,4,17,6,5,15,15,1,18,15,9,12,0,348,0,14,4,10,11,0,0,16
7,0,16,32,0,9,12,10,164,20,28,0,2,23,15,6,14,20,16,44,12,24,12,40,5,8,12,12,31,14,2,20,37,24,31,3,67,329,17,6,18,24,5,0,2,17,8,18,9,45,22,7,18,15,11,2,14,12,10,2,11,0,0,28
9,26,0,15,18,6,4,16,12,17,106,24,4,8,4,2,34,4,6,19,10,16,8,3,12,6,8,8,21,12,3,8,4,5,28,3,24,17,11,14,0,0,8,20,1,6,4,0,4,0,0,16,4,4,1,13,19,5,12,8,0,11,11,16
23,0,25,28,0,21,10,22,13,33,9,260,9,0,13,27,15,6,0,31,20,317,11,8,24,8,2,177,5,18,20,14,170,6,6,4,0,66,27,23,21,14,19,0,174,18,23,8,12,12,339,6,5,8,10,26,76,13,10,0,8,2,10,11
5,3,10,9,0,8,17,37,18,4,15,2,5,101,7,27,17,12,12,7,8,8,2,33,22,6,16,0,18,18,4,6,4,31,0,0,2,8,15,13,23,14,0,2,0,14,10,15,10,4,9,34,19,4,5,6,21,8,0,10,12,10,4,16
8,54,19,22,0,8,6,6,14,8,15,4,8,10,3,7,242,8,0,19,167,14,33,4,19,5200,16,17,4,11,4,11,40,30,2,10,11,10,12,10,39,9,0,2,0,73,289,33,6,18,19,160,7,20,12,13,2,0,8,13,5,12,14,8
0,24,6,4,0,80,274,4,9,14,2,3,150,20,8,84,10,7,4,24,25,3,8,3,16,2,153,1675,8,15,8,3,4,17,48,6,0,10,18,173,7,9,9,2,1,15,10,38,19,6,14,6,4,3,12,11,0,2,21,76,19,14,0,6
9,0,10,19,20,8,4,30,19,32,24,3,18,786,12,12,85,12,16,4,10,36,41,22,16,9,18,37,1,27,14,8,29,168,706,2,3,4,13,16,40,28,12,8,6,112,0,19,8,25,29,0,24,10,32,0,11,13,6,26,13,2,348,61
10,63,108,6,12,185,10,4,20,20,10,4,10,10,10,109,30,10,0,6,22,16,1,14,7,14,669,12,16,0,2,4,142,17,244,101,0,13,10,6,19,5,6,17,3,12,3,7,344,11,7,2,3,6,0,32,12,12,5,10,1,11,0,22
22,4,28,159,10,22,10,14,148,31,2,4,442,28,10,2559,92,45,26,66,94,17,73,12,29,33,8,58,8,1,2,6,12,10,61,16,3,6,183,428,30,124,2,89,183,400,0,4,16,9,28,379,9,0,6,10,3,20,4,8,4,15,12,633
0,17,9,16,16,16,46,10,31,14,2,0,1,18,149,24,2,32,242,13,48,4,10,14,14,397,2,15,21,631,1,73,1,10,8,0,9,53,5,6,16,18,247,2,8,26,18,6,6,18,11,1,0,9,3,24,4,7,19,5,4,18,9,16
12,0,2,7,1,7,40,6,49,8,2,8,12,2,11,6,317,27,1455,1,9,19,10,10,8,51,4,0,8,12,0,10,3,18,4,22,0,1,8,0,8,57,2,0,5,0,20,0,2,5,3,0,1,379,2,0,6,160,34,6,16,7,15,12
298,4,14,18,4,7,4,508,22,24,15,5,45,5,3,15,15,8,9,22,18,36,0,32,479,0,22,148,12,6,6,2,2,87,28,17,80,11,0,9,23,0,26,2,10,15,4,4,0,29,0,3,11,28,7,29,14,19,9,339,0,22,18,31
14,4,4,13,9,18,8,1,10,19,20,4,2,18,17,14,22,1,1,513,170,20,17,39,16,4,9,16,5,236,2,16,10,8,1005,8,0,16,6,10,28,12,10,0,178,22,0,0,4,0,29,5,18,9,11,25,6,18,4,12,0,45,1,26
114,2,56,13,0,36,0,14,2,49,4,0,27,10,21,184,19,4,5,2,14,1,0,4,4,12,622,7,0,14,8,0,303,2,0,4,280,12,6,3,135,20,58,2,3,18,33,674,0,4,0,2,6,16,344,8,19,6,10,12,4,9,15,2
2,0,0,4,8,325,0,132,10,8,18,2,8,0,34,66,318,22,4,0,9,17,25,18,2,12,9,33,0,3,2,6,132,16,0,1,8,4,8,1,9,0,8,0,17,4,2,0,674,0,4,0,6,4,7,19,38,33,15,8,0,18,15,12
8,9,19,28,3,9,15,5,237,9,6,223,7,6,27,121,127,29,7,18,6,8,15,17,16,25,9,104,4,6,4,4,9,4,0,24,4,8,13,9,28,21,67,6,0,20,0,2,33,0,4,20,18,0,3,0,10,289,10,23,4,8,5,11
280,2,16,12,12,7,506,18,14,8,3,2,10,6,14,25,8,12,46,27,17,20,8,4,9,13,1113,26,14,181,2,30,6,17,8,6,12,13,21,10,16,8,22,80,9,0,20,4,18,22,15,0,26,400,12,112,15,73,14,18,6,17,6,13
0,0,6,8,14,11,14,10,2,0,3,0,3,1,1,1,7,9,311,2,4,6,497,0,4,6,9,0,2,2,0,1,0,7,7,0,17,0,2,3,80,235,4,19,0,9,0,17,3,178,10,5,8,183,3,6,1,0,0,174,1,2,17,0
682,8,10,1,8,5,2,3,172,8,8,1,14,0,2,1,13,186,8,6,560,295,6,10,6,4,25,14,1,11,5,0,1155,5,8,0,19,0,11,2,3,270,4,0,19,80,6,0,2,0,2,0,2,89,17,8,2,2,2,0,20,0,4,18
3,4,28,12,12,4,17,28,113,182,4,0,6,0,10,13,16,10,104,8,25,14,12,3,20,19,10,31,16,4,12,3,14,1,3,90,5,18,16,5,2,106,0,4,4,22,67,8,58,10,26,2,247,2,6,12,9,0,0,19,8,5,11,20
115,8,18,32,2,22,246,11,0,14,15,605,27,84,26,4,2,121,287,5,26,13,26,6,5,2,16,8,5,29,11,13,582,2,23,14,2,2,8,8,18,0,106,270,235,8,21,0,20,12,0,57,18,124,5,28,9,9,14,14,0,24,2,10
418,2,15,27,10,34,31,14,186,24,4,4,14,6,6,22,271,226,16,19,22,18,19,8,20,14,179,137,8,0,9,13,21,62,26,16,8,5,7,17,0,18,2,3,80,16,28,9,135,28,23,8,16,30,19,40,7,39,23,21,0,18,15,16
6,15,1788,4,10,5,95,1089,21,188,2,0,120,2,0,601,0,9,16,50,190,0,86,4,6,16,0,905,12,12,6,8,1,4,125,12,80,269,12,0,17,8,5,2,3,10,9,1,3,10,9,0,6,428,6,16,173,10,13,23,14,6,12,8
9,0,2,26,48,8,0,6,162,16,17,0,8,13,20,10,18,0,9,2,682,14,33,8,2,18,6,1,5,4,14,0,12,12,23,8,6,4,0,12,7,8,16,11,2,21,13,8,6,6,0,8,5,183,10,13,18,12,15,27,11,17,6,16
9,4,95,257,20,68,14,35,4,9,6,254,68,13,6,23,165,2,8,11,28,27,28,8,284,0,0,52,20,108,5,20,18,11,18,18,1,0,4,269,5,2,18,0,0,13,8,4,12,16,11,1,53,6,13,4,10,10,8,66,17,329,2,6
0,0,33,4,0,0,0,28,0,8,0,25,1,8,7,0,2,6,18,2,19,5,8,10,0,4,2,765,75,12,0,15,3,6,2,11,0,1,6,80,8,2,5,19,17,12,4,8,280,0,80,0,9,3,0,3,0,11,2,0,24,67,4,8
0,12,584,0,0,4,41,0,4,8,6,2,2,651,8,2,10,18,11,4,24,12,8,6,19,0,214,2,18,8,7,1,19,28,6,0,11,18,8,12,16,14,90,0,0,6,24,1,4,8,17,22,0,16,101,2,6,10,0,4,3,3,10,4
8,4,4,10,4,618,75,6,7,4,8,18,112,16,18,226,60,34,11,12,10,2,74,82,9,8,12,694,18,1044,6,20,6,5,0,6,2,18,23,125,26,23,3,8,7,8,0,0,0,1005,28,4,8,61,244,706,48,2,0,6,28,31,2,10
268,2,8,6,5,5,6,6,9,4,0,0,13,17,8,16,76,10,28,18,26,16,17,2,4,17,11,5,9,10,8,24,12,0,5,28,6,11,12,4,62,2,1,5,7,17,4,16,2,8,87,18,10,10,17,168,17,30,31,6,5,24,7,12
50,2,20,6,12,5,26,16,11,2,15,12,4,7,10,28,27,32,17,16,12,14,8,10,15,848,14,92,48,8,999,10,0,12,6,19,3,18,12,1,21,582,14,1155,0,6,9,132,303,10,2,3,1,12,142,29,4,40,4,170,4,37,7,5
37,4,8,22,1,12,8,9,8,8,18,9,6,4,77,2,8,0,5,4,2,4,10,6,20,10,17,1,8,175,4,0,10,24,20,1,15,20,0,8,13,13,3,0,1,30,4,6,0,16,2,10,73,6,4,8,3,11,6,14,8,20,3,0
0,20,19,2,0,53,0,2,5,0,0,338,16,2,16,27,4,18,2,1506,8,5,20,4,10,19,4,6,2,12,0,4,999,8,6,7,0,5,14,6,9,11,12,5,0,2,4,2,8,2,6,0,1,2,2,14,8,4,4,20,3,2,0,10
10,0,7,0,8,374,8,24,4,8,26,2,14,9,919,13,40,847,2,13,18,4,326,636,339,7,12,0,6,0,12,175,8,10,1044,8,12,108,4,12,0,29,4,11,2,181,6,3,14,236,6,12,631,1,0,27,15,11,18,18,12,14,6,2
1,2,16,16,12,0,9,12,6,5,45,3,8,10,17,24,21,6,10,13,7,42,4,18,14,4,161,18,0,6,2,8,48,9,18,18,75,20,5,12,8,5,16,1,2,14,4,0,0,5,12,8,21,8,16,1,8,4,18,5,21,31,4,49
0,3,10,8,4,400,107,4,608,8,302,5,169,9,18,422,10,5,36,100,30,21,8,18,154,4,19,0,18,0,6,1,92,5,694,2,765,52,1,905,137,8,31,14,0,26,104,33,7,16,148,0,15,58,12,37,1675,17,0,177,8,12,1,12
8,1,173,21,0,17,9,16,32,30,10,7,0,2,10,13,34,4,5,16,10,210,15,16,43,6,0,19,161,12,4,17,14,11,12,214,2,0,6,0,179,16,10,25,9,1113,9,9,622,9,22,4,2,8,669,18,153,16,16,2,8,12,12,8
5,19,524,614,50,268,9,46,57,29,0,2,24,2,21,18,9,6,12,16,342,8,5,16,10,0,6,4,4,7,19,10,848,17,8,0,4,0,18,16,14,2,19,4,6,13,25,12,12,4,0,51,397,33,14,9,2,5200,6,8,6,8,1,8
15,4,29,422,4,14,6,26,46,22,502,7,17,7,10,4,33,18,3,19,148,41,52,6,0,10,43,154,14,339,10,20,15,4,9,19,0,284,2,6,20,5,20,6,4,9,16,2,4,16,479,8,14,29,7,16,16,19,22,24,12,5,21,39
10,2,28,8,285,17,8,11,10,1,12,0,4,0,15,19,10,2,10,27,18,38,5,0,6,16,16,18,18,636,4,6,10,2,82,6,10,8,8,4,8,6,3,10,0,4,17,18,4,39,32,10,14,12,14,22,3,4,33,8,3,40,0,248
26,2,13,30,9,101,10,10,7,14,4,184,23,4,6,10,107,45,10,14,20,15,0,5,52,5,15,8,4,326,20,10,8,17,74,8,8,28,33,86,19,26,12,6,497,8,15,25,0,17,0,10,10,73,1,41,8,33,2,11,8,12,14,867
586,0,24,12,8,34,19,16,26,5,27,12,4,16,6,14,28,229,9,36,220,0,15,38,41,8,210,21,42,4,5,4,14,16,2,12,5,27,14,0,18,13,14,295,6,20,8,17,1,20,36,19,4,17,16,36,3,14,8,317,16,24,12,69
10,17,20,4,9,4,3,2,51,30,15,2,14,63,21,26,11,7,18,42,0,220,20,18,148,342,10,30,7,18,8,2,12,26,10,24,19,28,682,190,22,26,25,560,4,17,6,9,14,170,18,9,48,94,22,10,25,167,8,20,10,12,8,15
8,8,63,33,22,30,4,23,3,13,6,4,12,19,29,16,16,4,506,0,42,36,14,27,19,16,16,100,13,13,1506,4,16,18,12,4,2,11,2,50,19,5,8,6,2,27,18,0,2,513,22,1,13,66,6,4,24,19,7,31,19,44,2,10
44,55,4,14,16,6,48,8,22,147,2,210,11,8,16,6,108,24,0,506,18,9,10,10,3,12,5,36,10,2,2,5,17,28,11,11,18,8,9,16,16,287,104,8,311,46,7,4,5,1,9,1455,242,26,0,16,4,0,12,0,6,16,82,16
4,187,12,343,1,46,482,2,39,8,4,3,5,6,9,2,5,0,24,4,7,229,45,2,18,6,4,5,6,847,18,0,32,10,34,18,6,2,0,9,226,121,10,186,9,12,29,22,4,1,8,27,32,45,10,12,7,8,12,6,4,20,23,13
14,9,13,762,8,11,0,21,26,16,12,7,6,12,16,22,0,5,108,16,11,28,107,10,33,9,34,10,21,40,4,8,27,76,60,10,2,165,18,0,271,2,16,13,7,8,127,318,19,22,15,317,2,92,30,85,10,242,17,15,34,14,7,30
16,2,13,28,7,94,5,28,2,14,0,9,247,1,22,0,22,2,6,16,26,14,10,19,4,18,13,422,24,13,27,2,28,16,226,2,0,23,10,601,22,4,13,1,1,25,121,66,184,14,15,6,24,2559,109,12,84,7,27,27,2,6,12,22
14,18,15,14,23,26,19,11,3,26,2,4,14,27,0,22,16,9,16,29,21,6,6,15,10,21,10,18,17,919,16,77,10,8,18,8,7,6,20,0,6,26,10,2,1,14,27,34,21,17,3,11,149,10,10,12,8,3,7,13,4,15,2,5
2,232,6,6,20,0,3,10,16,22,12,4,6,0,27,1,12,6,8,19,63,16,4,0,7,2,2,9,10,9,2,4,7,17,16,651,8,13,13,2,6,84,0,0,1,6,6,0,10,18,5,2,18,28,10,786,20,10,101,0,8,23,10,9
12,14,9,21,14,59,19,26,18,4,425,8,0,6,14,247,6,5,11,12,14,4,23,4,17,24,0,169,8,14,16,6,4,13,112,2,1,68,8,120,14,27,6,14,3,10,7,8,27,2,45,12,1,442,10,18,150,8,5,9,4,2,5,18
6,22,15,2,0,2073,1,9,0,1,8,0,8,4,4,9,7,3,210,4,2,12,184,0,7,2,7,5,3,2,338,9,12,0,18,2,25,254,0,0,4,605,0,1,0,2,223,2,0,4,5,8,0,4,4,3,3,4,2,260,24,0,35,13
167,0,14,5,0,23,3,19,4,10,0,8,425,12,2,0,12,4,2,6,15,27,4,12,502,0,10,302,45,26,0,18,15,0,8,6,0,6,17,2,4,15,4,8,3,3,6,18,4,20,15,2,2,2,10,24,2,15,15,9,106,28,13,10
6,4,36,7,544,39,7,23,13,0,10,1,4,22,26,14,16,8,147,13,30,5,14,1,22,29,30,8,5,8,0,8,2,4,4,8,8,9,16,188,24,14,182,8,0,8,9,8,49,19,24,8,14,31,20,32,14,8,4,33,17,20,15,36
10,9,6,30,10,145,1,7,0,13,4,0,18,16,3,2,26,39,22,3,51,26,7,10,46,57,32,608,6,4,5,8,11,9,7,4,0,4,162,21,186,0,113,172,2,14,237,10,2,10,22,49,31,148,20,19,9,14,18,13,12,164,32,104
3,0,40,13,0,10,9,0,7,23,19,9,26,10,11,28,21,2,8,23,2,16,10,11,26,46,16,4,12,24,2,9,16,6,6,0,28,35,6,1089,14,11,28,3,10,18,5,132,14,1,508,6,10,14,4,30,4,6,37,22,16,10,23,10
6,18,9,16,890,4,0,9,1,7,3,1,19,3,19,5,0,482,48,4,3,19,10,8,6,9,9,107,9,8,0,8,26,6,75,41,0,14,0,95,31,246,17,2,14,506,15,0,0,8,4,40,46,10,10,4,274,6,17,10,4,12,48,0
10,28,18,33,186,0,4,10,145,39,23,2073,59,0,26,94,11,46,6,30,4,34,101,17,14,268,17,400,0,374,53,12,5,5,618,4,0,68,8,5,34,22,4,5,11,7,9,325,36,18,7,7,16,22,185,8,80,8,8,21,6,9,11,14
2,15,485,8,0,186,890,0,10,544,0,0,14,20,23,7,8,1,16,22,9,8,9,285,4,50,0,4,12,8,0,1,12,5,4,0,0,20,48,10,10,2,12,8,14,12,3,8,0,9,4,1,16,10,12,20,0,0,0,0,18,0,0,7
8,2,18,0,8,33,16,13,30,7,5,2,21,6,14,28,762,343,14,33,4,12,30,8,422,614,21,8,16,0,2,22,6,6,10,0,4,257,26,4,27,32,12,1,8,12,28,4,13,13,18,7,16,159,6,19,4,22,9,28,15,32,2,7
4,19,0,18,485,18,9,40,6,36,14,15,9,6,15,13,13,12,4,63,20,24,13,28,29,524,173,10,16,7,19,8,20,8,4,584,33,95,2,1788,15,18,28,10,6,16,19,0,56,4,14,2,9,28,108,10,6,19,10,25,0,16,13,11
8,0,19,2,15,28,18,0,9,4,0,22,14,232,18,2,9,187,55,8,17,0,2,2,4,19,1,3,2,0,20,4,2,2,4,12,0,4,0,15,2,8,4,8,0,2,9,0,2,4,4,0,17,4,63,0,24,54,3,0,26,0,61,11
0,8,4,8,2,10,6,3,10,6,167,6,12,2,14,16,14,4,44,8,10,586,26,10,15,5,8,0,1,10,0,37,50,268,8,0,0,9,9,6,418,115,3,682,0,280,8,2,114,14,298,12,0,22,10,9,0,8,5,23,9,7,21,8
