0,16,24,0,4,12,1,8,12,0,4,4,3,16,1,0,371,346,4,25,12,2,1,9,7,19,9,2,9,17,3,6,12,2,0,6,4,0,12,2,8,2,2,342,0,3,10,2,6,0,0,39,10,5,4,2,12,6,10,181,12,15,1,9,2,16,280,19,7,23,0,0,8,55,15,8,14,0,2100,8,0,8,28,0,1,2,4,14,6,1,0,4,2,20,7,0
1,10,3,12,0,0,2,0,2,0,18,38,3,0,0,68,0,2,0,1,2,2,0,20,4,6,2,0,2,8,0,0,33,10,0,5,9,15,18,4,4,11,7,4,3,2,0,3,78,0,0,2,4,2,2,60,4,9,2,0,0,0,15,0,14,4,0,816,0,3,4,3,10,0,1911,1,8,38,6,0,0,18,670,4,5,4,0,1,243,3,1,0,2,11,0,7
72,14,0,2,4,13,8,10,6,21,252,0,0,45,0,16,0,0,0,12,10,0,0,2,38,18,0,7,12,7,5,8,2,4,16,120,36,10,14,0,4,10,7,65,2,2,0,0,2,19,2,8,9,6,12,0,2,6,0,4,0,9,2,25,0,6,10,9,10,2,2,13,0,5,30,0,350,4,9,76,14,6,3,4,4,21,5,22,13,54,3,1,579,0,11,20
4,2,113,0,4,335,0,11,6,0,33,2,0,7,0,0,0,0,4,4,2,593,3,9,12,4,0,8,11,6,296,8,1,0,13,8,4,2,1,2,4,3,14,11,377,10,2,1,53,888,0,10,32,39,1,7,2,12,2,1,3,510,4,22,48,4,2,4,8,12,24,104,0,1,28,4,0,284,0,5,0,172,11,10,170,4,2,0,6,6,26,0,0,579,2,2
0,8,0,1,4,2,8,0,0,0,3,2,1,1,0,27,0,0,1,0,5,2,4,0,0,0,2,1,6,0,16,0,0,2,2,2,1,19,88,0,6,2,8,6,1,8,2,657,0,3,113,4,8,0,595,0,0,0,4,0,506,2011,8,2,5,2813,0,10,3,0,15,4,24,10,0,1,4,14,2,2,1,0,0,0,1,0,5,41,2,1,0,0,0,1,0,4
8,0,0,4,144,0,457,0,3,22,1,0,1021,2,4,0,2,3,2,484,0,1,2,0,3,2,0,0,496,0,1,0,0,0,2,169,100,0,607,14,2,3,0,0,4,4,1,2,0,0,2,11,1,29,3,28,8,1,165,9,2,4,2,2,35,182,603,3,53,451,8,5,2,12,2,10,0,4,0,0,86,321,6,291,0,0,0,2,29,3,0,0,26,3,1,0
8,6,7,8,2,18,8,1,323,9,2,6,8,0,0,2,0,1,4,11,20,2,10,0,388,26,6,4,21,2,21,16,9,0,12,8,16,1,10,17,3,6,24,12,8,0,2,0,4,8,2,13,2,2,10,161,12,10,0,4,24,19,8,8,0,12,104,10,13,13,2,503,1,0,9,481,9,1,486,5,0,4,0,6,0,4,4,10,2,0,3,1,6,54,3,1
0,2,8,12,72,18,8,4,3,5,0,4,6,8,0,2,6,0,4,5,3,0,9,6,17,0,3,3,32,7,16,3,12,883,0,0,2,39,14,16,742,8,16,11,20,2,4,0,8,20,8,3,3,10,7,2,0,11,9,14,5,11,8,4,40,2,2,14,0,2,2,6,2,4,0,6,6,6,2,42,53,11,174,16,6,2,10,23,0,2,29,2,6,13,243,6
13,7,4,8,52,18,0,6,10,5,12,0,0,2,10,5,3,6,2,7,2,0,107,36,21,8,6,12,37,6,3,18,10,1,50,10,12,215,28,16,8,6,18,7,26,3,2,2,10,23,2,11,3,6,10,2,22,4,8,38,326,6,12,14,6,7,3,20,38,11,12,16,20,9,7,11,9,12,6,20,21,15,14,24,2,5,37,0,23,10,2,41,0,22,1,14
2,10,108,204,4,14,39,11,8,0,1,0,1,8,8,2,0,3,8,13,1,0,12,21,12,0,1,12,16,4,8,10,12,2,17,4,1,0,4,6,0,5,0,9,6,2,11,2,11,8,3,10,6,17,26,0,11,0,4,12,114,11,1,7,6,174,9,3,2,6,16,10,4,1539,66,13,5,2,0,11,9,1,7,0,15,1,0,37,10,4,0,5,2,5,0,4
0,2,4,2,4,10,12,16,3,2,12,0,71,4,7,2,0,0,602,8,0,2,10,2,2,5,2,0,5,10,21,4,3,0,238,0,10,0,2,2,2113,0,3,2,2,1,2501,44,3,2,3,3,2,2,0,0,6,2,2,3,5,6,2,4,11,1,20,0,0,2,732,0,0,6,280,13,0,2,2,2,9,4,4,4,1,0,1,5,2,4,0,0,4,21,4,2
3,8,2,9,10,4,19,9,2,511,98,76,0,12,6,5,0,181,11,16,15,0,6,9,14,7,4,4,10,4,12,328,4,1,17,9,3,234,8,196,10,0,4,4,173,0,0,3,46,33,0,6,112,2,0,2,16,0,26,3,4,6,0,43,13,4,4,5,2,7,5,13,0,14,2,10,10,5,3,4,7,2,28,13,0,1,15,2,6,0,0,1,170,4,5,1
4,6,1972,0,6,16,51,4,56,2,0,4,66,0,7,0,8,1,10,7,0,10,16,0,12,4,0,0,4,4,4,28,336,0,5,0,7,0,9,16,4,0,4,1,0,2,4,0,0,12,0,11,5,12,5,8,153,0,8,6,2,12,10,6,6,16,2,19,44,161,4,62,4,2,11,20,0,10,6,0,0,10,4,0,13,4,0,24,16,6,291,0,10,4,4,0
5,10,4,0,16,10,0,0,12,64,8,2,2,13,4,4,2,0,12,6,20,81,0,262,16,4,0,3,7,4,113,15,220,1,6,6,17,8,9,2,27,0,8,14,0,6,98,0,14,569,2,0,3,5,2,3,14,8,1,6,186,0,4,15,9,1386,116,924,0,10,9,134,9,361,2,336,10,2,8,3,9,567,0,4,28,4,7,14,174,0,6,0,11,3,670,28
10,10,18,8,10,28,10,12,10,12,24,0,60,6,14,3,6,15,2,81,4,18,14,12,18,10,0,8,143,17,4,47,423,4,20,3,6,4,18,2,12,22,5,4,121,0,19,8,16,1,2,14,977,0,9,2,18,13,8,4,9,8,2,7,24,3,11,13,9,480,751,26,2,96,5,199,4,4,0,15,8,0,567,10,2,4,1,15,11,4,321,0,172,6,18,8
24,0,2,2,10,2,0,1,0,4,0,0,0,185,0,0,4,1,14,9,2,2,10,24,11,0,15,3,17,2,2,6,8,0,8,4,6,4,5,10,0,4,0,8,282,0,2,22,2,4,99,3,2,2,17,12,71,11,0,8,8,4,2,4,0,8,2,0,8,4,5,2,2,0,4,1246,13,2,1,8,0,8,9,0,7,9,9,21,53,0,86,1,0,14,0,0
0,1,5,2,57,0,3,0,98,2,12,0,0,0,0,9,0,5,10,2,4,8,4,6,0,0,3,4,11,2,0,2,2,1,8,2,4,48,4,5,0,2,588,0,0,0,11,8,10,2,0,4,6,12,0,50,4,115,11,16,3,16,0,4,39,0,0,36,0,3,2,9,39,17,3,0,13,0,0,0,8,15,3,0,4,2,11,20,42,5,0,2,5,76,0,8
8,6,6,20,13,64,0,213,0,6,0,0,10,2,0,0,0,1,1,8,11,4,0,12,1,10,0,0,15,6,11,12,0,0,0,2,4,0,1,10,950,0,9,2,0,6,0,4,11,10,0,10,12,1,7,0,9,3,12,0,6,496,1,12,5,1,4,21,9,16,2,1,12,8,686,12,15,5,0,0,1,0,8,6,3,2,0,6,2,486,0,2,0,9,6,2100
3,7,2,8,0,6,2,0,0,4,0,0,2,8,0,43,0,9,10,1,10,8,1,0,6,0,2,4,1,10,10,0,8,11,0,0,3,4,6,4,0,0,4,8,449,4,2,2,3,297,4,0,3,0,0,41,3,2,0,1,0,2,8,6,2,9,0,0,2,0,14,7,17,0,0,9,5,0,5,0,2,4,2,10,5,2,2,12,6,1,4,14,284,4,38,0
4,8,4,23,12,8,0,0,10,20,1,2,4,10,0,8,4,10,4,1,33,4,11,0,6,10,3,3,16,6,4,7,0,0,6,333,3,0,8,2,14,1,4,19,0,0,8,8,0,8,4,5,0,19,8,1,8,240,0,2,0,86,2,8,8,0,0,1,112,0,0,1,12,3,12,0,0,5,15,13,13,4,10,0,10,0,5,9,6,9,0,4,0,350,8,14
9,6,12,21,14,0,4,18,9,534,2,3,3,1,12,8,170,2,12,9,2,30,4,9,30,3,5,246,12,4,26,11,8,0,7,2,109,4,10,9,6,0,22,19,0,5,7,144,29,8,8,26,11,13,15,7,18,9,8,5,77,12,0,344,16,303,10,17,29,6,10,2,10,9,18,0,0,9,12,0,1246,199,336,20,10,13,13,11,6,481,10,1,4,0,1,8
0,3,256,17,7,6,29,6,670,27,2,248,14,20,122,2,3,0,12,13,18,20,2,11,10,4,3,0,0,20,16,33,4,0,0,12,24,0,4,12,950,0,15,9,0,4,12,26,6,4,4,12,2,6,0,0,32,8,8,5,37,38,4,31,210,28,0,20,4,14,86,19,1,19,0,18,12,0,686,3,4,5,2,11,2,280,66,7,0,9,2,0,28,30,1911,15
156,0,3,182,52,1,0,2,26,5,8,4,6,88,16,8,2,0,0,20,2,4,2,1,1,4,2,0,0,19,8,111,1,0,3,8,11,0,3,299,8,1,3,14,0,1,271,0,30,3,0,27,1,1,5,0,6,0,12,6,8,4,9,7,2,8,7,8,4,8,5,3,4,0,19,9,3,0,8,17,0,96,361,2,14,6,1539,9,4,0,12,10,1,5,0,55
0,0,8,259,38,46,17,2,3,10,44,2,3,1,10,39,2,0,0,92,12,3,2,18,16,0,1,10,6,10,11,18,102,382,4,651,2,61,2,2,8,5,0,7,4,2,2,0,9,4,5,6,4,8,0,2,0,1,4,2,2,8,0,10,4,243,4,3,18,1,2,2,0,4,1,10,12,17,12,39,2,2,9,4,0,0,4,20,2,1,2,24,0,0,10,8
2,5,35,1,37,123,1,2,137,8,4,0,48,4,0,11,104,3,0,12,0,1,2,13,18,27,1,223,24,232,4,2,467,0,24,10,25,6,6,158,10,12,2,9,4,4,0,4,2,80,0,11,0,20,3,1,20,8,100,10,9,248,0,6,26,10,366,11,302,50,2,0,2,3,19,2,1,7,1,9,2,26,134,62,13,0,10,16,6,503,5,4,104,13,3,0
4,0,0,0,4,1,2,0,2,20,12,2,0,36,3,9,45,2,46,26,0,2,17,2,7,8,4,0,4,4,326,12,10,435,7,2,4,4,228,14,10,3,6,11,1,21,124,40,0,1,8,76,0,22,70,2,9,0,8,90,0,22,12,2,11,14,8,1,4,9,0,2,2,5,86,10,0,14,2,2,5,751,9,4,5,732,16,12,2,2,8,15,24,2,4,0
249,18,33,18,5,10,6,5,19,16,8,2,226,2,1,12,2,0,275,0,14,18,6,5,4,30,8,0,19,4,0,22,12,4,181,16,38,1,12,8,6,14,7,13,2,0,4,2,3,3,0,13,0,12,16,2,66,0,14,2,10,10,1,26,14,7,5,11,8,0,9,50,1,8,14,6,0,0,16,3,4,480,10,161,7,2,6,11,2,13,451,0,12,2,3,23
1,1,4,21,30,2,252,8,0,10,1,0,84,0,3,0,0,2,0,14,4,12,6,0,9,4,3,3,0,8,0,16,0,0,16,267,455,0,4,13,8,0,8,12,0,0,2,0,18,2,2,8,20,6,8,80,18,0,326,2,0,102,0,10,20,17,0,8,0,8,4,302,18,4,4,29,112,2,9,0,8,9,0,44,2,0,2,38,0,13,53,3,8,10,0,7
25,12,301,8,28,5,4,13,801,7,8,4,5,0,14,10,6,13,884,14,0,500,14,512,26,1,1,6,2,40,45,143,10,12,6,0,6,0,14,10,67,2,22,4,0,8,0,8,4,0,4,4,0,5,13,644,16,6,17,10,23,23,6,2,16,12,3,0,8,11,1,11,3,8,20,17,1,0,21,36,0,13,924,19,5,0,3,20,14,10,3,10,4,9,816,19
5,6,1,6,5,4,0,2,68,2,0,48,61,7,0,418,2270,336,0,266,0,0,29,2,2,2,7,6,4,5,6,6,16,2,6,9,4,0,8,48,5,4,5,0,0,0,422,0,22,2,45,8,0,3,2,13,30,1,4,48,1,8,2,20,16,50,0,3,0,5,8,366,4,7,0,10,0,0,4,0,2,11,116,2,4,20,9,3,2,104,603,0,2,10,0,280
15,1255,10,39,6,8,301,20,0,28,6,6,391,2,18,4,191,6,3,22,31,164,437,4,16,1,0,357,15,81,0,17,10,2,9,2,34,3,0,2,5,2,13,16,24,129,1547,5,4,10,0,6,0,8,0,236,26,4,0,13,685,4,0,130,21,0,50,12,17,7,14,10,243,8,28,303,0,9,1,0,8,3,1386,16,4,1,174,7,2,12,182,2813,4,6,4,16
21,2,6,0,13,25,8,8,397,58,17,3,10,13,2,0,1,1,5,21,6,78,23,6,13,8,5,20,2,190,207,24,16,2,25,4,14,26,7,4,3,12,20,6,2,3,12,6,8,10,2,2,17,52,20,12,32,23,570,2,28,6,12,16,0,21,16,16,20,14,11,26,4,2,210,16,8,2,5,39,0,24,9,6,13,11,6,6,40,0,35,5,48,0,14,2
2,19,2,0,5,17,16,8,2,4,10,2,0,37,7,2,0,2,7,14,0,11,5,6,48,10,13,14,10,17,196,14,1,0,3,8,33,2,2,4,1,1,3,7,0,6,3,0,10,10,15,11,6,8,17,4,322,2,14,4,5,20,8,0,16,130,20,2,10,26,2,6,10,7,31,344,8,6,12,4,4,7,15,6,43,4,7,14,4,8,2,2,22,25,0,9
127,8,0,6,3,18,0,163,2,2,0,0,2,57,6,8,2,3,2,544,4,13,28,37,3,8,35,3,8,2,2,9,52,1,4,2,22,1,2,22,54,13,5,8,92,2,0,10,4,10,0,300,0,4,2,628,6,0,5,2,4,8,0,8,12,0,2,6,0,1,12,0,0,9,4,0,2,8,1,0,2,2,4,10,0,2,1,12,8,8,2,8,4,2,15,1
21,8,16,8,17,154,1201,320,4,43,4,0,2,20,112,12,2,3,4,5,12,17,19,4,12,0,464,0,21,8,11,1,4,1,15,16,21,2,17,16,7,8,6,2,2,8,6,20,4,7,18,16,4,15,12,45,12,6,1,6,4,0,8,20,6,4,8,23,102,10,22,248,8,4,38,12,86,2,496,16,4,8,0,12,6,6,11,6,11,19,4,2011,510,9,0,15
6,635,150,5,1,7,2,9,0,9,5,0,10,13,7,0,0,0,260,5,13,12,9,1045,6,0,0,7,4,12,1,13,0,3,7,2,16,116,0,3,15,2,326,7,8,279,1745,8,17,75,4,10,0,12,64,2,1,5,11,10,0,4,4,5,28,685,1,23,0,10,0,9,2,8,37,77,0,0,6,3,8,9,186,2,4,5,114,326,5,24,2,506,3,0,0,12
4,3,0,0,0,2,0,0,0,6,2,62,4,6,6,6,715,0,0,31,0,4,12,2,20,4,2,0,16,2,5,6,0,3,11,0,10,8,411,15,0,356,1,24,71,0,1,2,0,8,62,7,57,14,10,0,6,0,8,0,10,6,2,4,2,13,48,10,2,2,90,10,2,6,5,5,2,1,0,16,8,4,6,6,3,3,12,38,14,4,9,0,1,4,0,181
8,5,0,6,12,6,30,12,2,18,28,2,40,4,13,18,268,3,10,13,0,0,2,2,16,8,0,13,11,0,284,12,0,1,8,0,7,8,10,8,2,2,5,8,0,2,3,2,12,34,4,18,2,10,3,9,39,8,0,8,11,1,5,14,570,0,4,17,326,14,8,100,4,12,8,8,0,0,12,11,0,8,1,8,26,2,4,8,9,0,165,4,2,0,2,10
14,340,10,8,21,5,1,0,7,4,3,0,0,0,4,5,0,3,6,9,5,2,2,4,0,380,2,1,0,0,2,0,4,4,606,3,6,5,8,7,0,0,0,0,1,12,0,89,0,0,0,0,0,3,19,2,2,0,8,0,5,6,0,2,23,4,1,6,0,0,0,8,1,0,8,9,240,2,3,115,11,13,8,0,0,2,0,4,11,10,1,0,12,6,9,6
322,20,52,7,3,16,13,5,42,0,13,8,51,2,6,1,4,8,4,25,0,0,8,4,0,2,2,152,7,12,2,45,2,0,20,3,8,4,9,10,26,0,8,7,136,2,8,4,22,24,0,6,0,2,7,2,0,2,39,6,1,12,6,322,32,26,30,16,18,66,9,20,0,6,32,18,8,3,9,4,71,18,14,153,16,6,11,22,0,12,8,0,2,2,4,12
4,0,0,2,7,3,2,147,584,10,4,2,0,2,0,21,1,4,1,3,0,8,8,34,14,4,4,12,1,2,613,36,26,2,2,0,5,2,2,15,0,15,4,12,351,2,734,2,1,12,1,4,0,42,15,0,2,2,9,0,2,45,628,4,12,236,13,644,80,2,2,1,2,0,0,7,1,41,0,50,12,2,3,8,2,0,0,2,2,161,28,0,7,0,60,2
8,2,423,1,21,19,187,4,4,3,224,0,4,5,5,402,4,10,2,10,6,2,8,4,4,2,2,12,10,7,1,87,1,0,31,825,27,1,7,8,24,2,4,4,9,190,0,0,9,18,0,10,6,9,0,15,7,19,3,10,64,12,2,17,20,0,2,13,8,16,70,3,0,5,0,15,8,0,7,0,17,9,2,5,0,0,26,10,7,10,3,595,1,12,2,4
0,15,20,2,12,2,7,2,8,3,21,12,7,0,4,5,0,2,0,6,10,16,9,8,10,14,2,6,20,13,14,3,2,175,3,2,16,8,11,12,4,2,18,8,429,0,62,6,6,14,2,15,44,0,9,42,2,3,10,14,12,15,4,8,52,8,3,5,6,12,22,20,8,1,6,13,19,0,1,12,2,0,5,12,2,2,17,6,10,2,29,0,39,6,2,5
0,8,5,16,9,5,4,2,3,0,52,0,4,3,0,5,457,0,0,8,2,0,18,7,0,9,104,0,58,6,6,4,0,0,6,6,2,10,234,4,9,1,0,2,0,2,14,0,674,47,0,8,0,44,6,0,0,0,2,57,0,4,0,6,17,0,0,0,20,0,0,0,4,1,2,11,0,3,12,6,2,977,3,5,112,2,6,3,3,2,1,8,32,9,4,10
153,0,1,13,385,1,5,87,40,21,3,0,6,0,249,0,2,0,1,20,3,70,8,9,5,6,39,0,18,7,274,6,2,2923,2,12,4,157,190,0,263,12,5,11,0,0,2,0,4,1024,2,0,8,15,10,4,6,0,18,7,10,16,300,11,2,6,8,4,8,13,76,11,6,27,12,26,5,0,10,4,3,14,0,11,6,3,10,11,3,13,11,4,10,8,2,39
0,3,2,2,14,3,0,6,4,8,2,28,2,2,20,104,8,4,1,8,4,0,0,10,5,1,2,3,4,0,2,5,0,1,11,7,16,2,14,10,0,0,0,86,65,65,0,4,8,0,0,2,0,2,0,1,0,0,4,62,4,18,0,15,2,0,45,4,2,0,8,0,5,0,4,8,4,4,0,0,99,2,2,0,0,3,3,2,8,2,2,113,0,2,0,0
10,0,1,2,10,4,22,5,0,4,51,12,8,106,3,46,0,10,0,18,0,89,11,274,6,142,3,2,16,14,36,2,4,0,100,9,17,11,43,8,10,15,5,7,117,76,146,6,12,0,0,1024,47,14,18,12,24,0,34,8,75,7,10,10,10,10,2,0,2,3,1,80,4,3,4,8,8,297,10,2,4,1,569,12,33,2,8,23,20,8,0,3,888,19,0,0
5,3,15,10,3,16,8,3,5,2,0,0,2,10,8,8,0,2,3,0,4,54,6,4,10,2,0,2,26,10,3,9,111,0,2,0,18,0,217,3,8,2,6,1,2,0,5,7,0,12,8,4,674,6,9,1,22,0,12,0,17,4,4,10,8,4,22,4,18,3,0,2,9,30,6,29,0,3,11,10,2,16,14,0,46,3,11,10,8,4,0,0,53,2,78,6
0,0,8,4,9,1,3,2,0,0,0,162,7,2,6,0,33,1,5,11,18,10,2,4,3,0,12,0,0,11,2,12,0,9,0,0,4,4,0,10,6,2,14,7,866,8,74,0,7,6,4,0,0,6,0,2,4,89,2,2,8,20,10,0,6,5,0,8,0,2,40,4,0,0,26,144,8,2,4,8,22,8,0,0,3,44,2,2,0,0,2,657,1,0,3,2
0,4,7,2,1,0,2,0,0,0,5,0,14,2,6,3,74,2,34,0,8,0,9,2,7,4,0,180,60,0,1,11,0,40,2,2,6,4,0,226,2,4,132,89,4,8,0,74,5,146,0,2,14,62,0,734,8,0,3,1,1745,6,0,3,12,1547,422,0,2,4,124,0,2,271,12,7,8,2,0,11,2,19,98,4,0,2501,11,2,4,2,1,2,2,0,0,10
0,1,0,2,4,76,4,0,0,8,181,11,5,6,0,0,61,15,67,0,4,207,0,12,8,0,8,11,0,11,179,2,6,0,2,0,961,0,2,114,4,0,457,4,68,0,8,8,0,76,65,0,2,0,190,2,2,12,2,0,279,8,2,6,3,129,0,8,0,0,21,4,2,1,4,5,0,4,6,0,0,0,6,2,0,1,2,3,2,0,4,8,10,2,2,3
220,1,4,72,0,6,0,6,3,0,1,6,2,0,0,3,4,85,55,2,0,2,146,0,10,0,2,0,2,1,5,0,0,491,7,0,2,8,0,4,2,0,4,129,0,68,4,866,2,117,65,0,0,429,9,351,136,1,0,71,8,2,92,0,2,24,0,0,0,2,1,4,4,0,0,0,0,449,0,0,282,121,0,0,173,2,6,26,20,8,4,1,377,2,3,0
15,13,24,0,16,118,0,10,1,1,2,303,24,10,2,1,46,0,226,0,20,0,4,10,24,4,0,40,23,22,12,1,12,0,2,4,16,222,22,10,60,1,26,0,129,4,89,7,1,7,86,11,2,8,4,12,7,0,8,24,7,2,8,7,6,16,0,4,12,13,11,9,7,14,9,19,19,8,2,0,8,4,14,1,4,2,9,7,11,12,0,6,11,65,4,342
16,4,8,9,12,204,0,1180,4,10,13,10,14,6,10,1,1,0,4,4,17,2,207,10,12,18,9,0,22,29,8,10,2,0,15,0,16,30,6,352,2,6,0,26,4,457,132,14,6,5,0,5,0,18,4,4,8,0,5,1,326,6,5,3,20,13,5,22,8,7,6,2,0,3,15,22,4,4,9,588,0,5,8,4,4,3,0,18,16,24,0,8,14,7,7,2
8,7,2,3,2,6,0,2,0,0,0,9,7,2,0,1,0,1,0,1,1,0,2,26,4,0,3,5,20,4,500,9,0,0,6,0,3,2,2,0,0,0,6,1,0,0,4,2,2,15,0,12,1,2,2,15,0,0,2,356,2,8,13,1,12,2,4,2,0,14,3,12,5,1,0,0,1,0,0,2,4,22,0,0,0,0,5,6,8,6,3,2,3,10,11,2
102,4,97,0,1,1,4,142,0,8,2,2,185,0,163,2,2,0,6,0,8,4,338,0,0,9,0,0,8,5,4,13,576,0,0,0,3,2194,0,0,0,0,2,60,2,4,2,6,8,10,0,263,9,4,24,0,26,0,2,0,15,7,54,1,3,5,5,67,8,6,10,10,8,8,950,6,14,0,950,0,0,12,27,4,10,2113,0,8,742,3,2,6,4,4,4,8
0,11,3,35,11,8,0,5,3,2,7,70,2,2,8,29,6,8,8,6,6,5,0,4,2,2,34,2,10,2,6,6,73,0,14,0,22,6,8,0,0,0,352,10,4,114,226,10,3,8,10,0,4,12,8,15,10,7,8,15,3,16,22,4,4,2,48,10,13,8,14,158,2,299,12,9,2,4,10,5,10,2,2,16,196,2,6,16,16,17,14,0,2,0,4,2
32,20,3,16,14,6,5,67,49,2,4,0,3,8,11,131,4,8,0,3,7,6,18,256,133,6,9,8,14,4,5,956,0,3,12,2,5,0,0,8,0,2,6,22,0,2,0,0,217,43,14,190,234,11,7,2,9,8,10,411,0,17,2,2,7,0,8,14,4,12,228,6,2,3,4,10,8,6,1,4,5,18,9,9,8,2,4,28,14,10,607,88,1,14,18,12
2,0,10,0,2,0,2,142,8,0,15,0,1,2,2,43,4,2,2,30,0,0,4,0,1,8,4,3,4,8,0,5,4,0,6,1,1,0,0,6,2194,2,30,222,8,0,4,4,0,11,2,157,10,8,1,2,4,5,8,8,116,2,1,2,26,3,0,0,0,1,4,6,61,0,0,4,0,4,0,48,4,4,8,0,234,0,0,215,39,1,0,19,2,10,15,0
18,10,18,2,55,8,2,28,4,19,21,3,4,2,2,7,4,4,6,16,32,49,22,12,15,14,14,378,15,12,7,21,2,2,327,4,0,1,5,22,3,3,16,16,2,961,6,4,18,17,16,4,2,16,27,5,8,6,7,10,16,21,22,33,14,34,4,6,455,38,4,25,2,11,24,109,3,3,4,4,6,6,17,7,3,10,1,12,2,16,100,1,4,36,9,4
0,2827,0,0,9,0,6,0,0,8,8,2,19,13,2,10,2,151,0,383,0,0,320,6,10,3,8,8,8,8,0,15,7,0,2,0,4,1,2,0,0,0,0,4,0,0,2,0,0,9,7,12,6,2,825,0,3,3,0,0,2,16,2,8,4,2,9,0,267,16,2,10,651,8,12,2,333,0,2,2,4,3,6,0,9,0,4,10,0,8,169,2,8,120,5,6
307,27,10,13,40,7,16,9,13,13,6,4,8,188,4,12,5,3,2,15,10,10,15,4,15,12,27,114,25,7,4,10,5,2,0,2,327,6,12,14,0,6,15,2,7,2,2,0,2,100,11,2,6,3,31,2,20,606,8,11,7,15,4,3,25,9,6,6,16,181,7,24,4,3,0,7,6,0,0,8,8,20,6,5,17,238,17,50,0,12,2,2,13,16,0,0
149,0,0,0,0,0,0,6,4,6,0,8,0,0,577,13,1,5,2,5,0,4,4,4,0,0,2,0,0,548,340,2,0,0,2,0,2,0,3,0,0,0,0,0,491,0,40,9,0,0,1,2923,0,175,0,2,0,4,1,3,3,1,1,0,2,2,2,12,0,4,435,0,382,0,0,0,0,11,0,1,0,4,1,0,1,0,2,1,883,0,0,2,0,4,10,2
16,8,396,5,0,61,5,1,4,18,7,81,3,0,10,11,0,0,12,13,8,0,4,7,0,11,43,0,182,1,2,272,0,0,5,7,2,4,0,73,576,0,2,12,0,6,0,0,111,4,0,2,0,2,1,26,2,4,0,0,0,4,52,1,16,10,16,10,0,12,10,467,102,1,4,8,0,8,0,2,8,423,220,336,4,3,12,10,12,9,0,0,1,2,33,12
440,4,272,19,7,128,2,8,329,11,5,119,59,30,12,665,2,2,11,7,13,10,5,13,18,16,0,4,20,0,0,0,272,2,10,15,21,5,956,6,13,9,10,1,0,2,11,12,9,2,5,6,4,3,87,36,45,0,12,6,13,1,9,14,24,17,6,143,16,22,12,2,18,111,33,11,7,0,12,2,6,47,15,28,328,4,10,18,3,16,0,0,8,8,0,6
224,0,0,942,15,4,4,26,146,0,5,12,4,5,2,16,0,1,1,2,7,997,8,0,3,10,4,1,498,14,0,0,2,340,4,0,7,0,5,6,4,500,8,12,5,179,1,2,3,36,2,274,6,14,1,613,2,2,284,5,1,11,2,196,207,0,6,45,0,0,326,4,11,8,16,26,4,10,11,0,2,4,113,4,12,21,8,3,16,21,1,16,296,5,0,3
9,116,6,2,12,572,0,8,0,8,6,2,0,14,0,0,2,3,1,4,8,8,4,88,18,10,9,1,24,0,14,0,1,548,7,8,12,8,4,2,5,4,29,22,1,11,0,11,10,14,0,7,6,13,7,2,12,0,0,2,12,8,2,17,190,81,5,40,8,4,4,232,10,19,20,4,6,10,6,2,2,17,4,4,4,10,4,6,7,2,0,0,6,7,8,17
4,10,4,10,10,148,3,1,8,2,5,2,3,2,0,30,0,1,0,8,4,104,1,20,18,0,2,1105,0,24,498,20,182,0,25,8,15,4,14,10,8,20,22,23,2,0,60,0,26,16,4,18,58,20,10,1,7,0,11,16,4,21,8,10,2,15,4,2,0,19,4,24,6,0,0,12,16,1,15,11,17,143,7,4,10,5,16,37,32,21,496,6,11,12,2,9
8,6,0,0,18,6,0,16,4,2,0,2,0,8,0,5,17,14,24,317,8,12,8,0,15,6,1357,0,1105,1,1,4,0,0,114,8,378,3,8,2,0,5,0,40,0,11,180,0,2,2,3,0,0,6,12,12,152,1,13,0,7,0,3,14,20,357,6,6,3,0,0,223,10,0,0,246,3,4,0,4,3,8,3,0,4,0,12,12,3,4,0,1,8,7,0,2
8,12,0,8,235,350,8,4,1,5,0,0,1,1,0,9,3,8,2,5,0,245,13,190,7,25,0,1357,2,9,4,0,43,2,27,8,14,4,9,34,0,3,9,0,2,8,0,12,0,3,2,39,104,2,2,4,2,2,0,2,0,464,35,13,5,0,7,1,3,8,4,1,1,2,3,5,3,2,0,3,15,0,0,0,4,2,1,6,3,6,0,2,0,0,2,9
0,11,16,4,5,8,0,4,2,0,18,0,8,29,1,7,0,150,0,9,8,6,0,4,0,0,25,6,0,10,10,16,11,0,12,3,14,8,6,2,9,0,18,4,0,0,4,0,2,142,1,6,9,14,2,4,2,380,8,4,0,0,8,10,8,1,2,1,4,30,8,27,0,4,4,3,10,0,10,0,0,10,4,4,7,5,0,8,0,26,2,0,4,18,6,19
28,22,5,7,4,8,0,83,35,3,14,4,3,104,2,3,2,3,2,8,4,12,10,28,0,0,7,15,18,18,3,18,0,0,15,10,15,1,133,2,0,4,12,24,10,8,7,3,10,6,5,5,0,10,4,14,0,0,16,20,6,12,3,48,13,16,2,26,9,4,7,18,16,1,10,30,6,6,1,0,11,18,16,12,14,2,12,21,17,388,3,0,12,38,4,7
1,1,3,6,10,28,0,2,2,12,0,2,6,2,4,1,0,0,1019,8,7,4,4,0,28,4,190,0,20,88,0,13,7,4,4,6,12,0,256,4,0,26,10,10,0,12,2,4,4,274,10,9,7,8,4,34,4,4,2,2,1045,4,37,6,6,4,2,512,0,5,2,13,18,1,11,9,0,0,12,6,24,12,262,0,9,2,21,36,6,0,0,0,9,2,20,9
15,0,8,15,379,9,0,28,12,23,0,0,4,8,0,1,8,2192,2,9,9,8,0,4,10,0,13,8,1,4,8,5,4,4,15,320,22,4,18,0,338,2,207,4,146,0,9,2,6,11,0,8,18,9,8,8,8,2,2,12,9,19,28,5,23,437,29,14,6,6,17,2,2,2,2,4,11,1,0,4,10,14,0,16,6,10,12,107,9,10,2,4,3,0,0,1
8,1091,10,0,0,19,2,16,2,18,1,0,103,5,6,1,2,41,3,4,32,0,8,4,12,6,245,12,104,8,997,10,0,4,10,0,49,0,6,5,4,0,2,0,2,207,0,10,54,89,0,70,0,16,2,8,0,2,0,4,12,17,13,11,78,164,0,500,12,18,2,1,3,4,20,30,4,8,4,8,2,18,81,10,0,2,0,0,0,2,1,2,593,0,2,2
5,34,14,20,8,146,0,82,8,4,8,4,4,6,16,8,0,2,4,20,0,32,9,7,4,8,0,8,4,8,7,13,8,0,10,0,32,0,7,6,8,1,17,20,0,4,8,18,4,0,4,3,2,10,6,0,0,5,0,0,13,12,4,0,6,31,0,0,4,14,0,0,12,2,18,2,33,10,11,4,2,4,20,0,15,0,1,2,3,20,0,5,2,10,2,12
4,3,5,13,361,48,10,1,6,9,6,0,322,187,6,4,0,2,7,0,20,4,9,8,8,9,5,317,8,4,2,7,13,5,15,383,16,30,3,6,0,1,4,0,2,0,0,11,0,18,8,20,8,6,10,3,25,9,13,31,5,5,544,14,21,22,266,14,14,0,26,12,92,20,13,9,1,1,8,2,9,81,6,7,16,8,13,7,5,11,484,0,4,12,1,25
6,180,2131,14,12,5,10,6,0,2,2,22,31,50,5,0,85,20,0,7,4,3,2,1019,2,0,2,24,0,1,1,11,12,2,2,0,6,2,0,8,6,0,4,226,55,67,34,5,3,0,1,1,0,0,2,1,4,6,10,0,260,4,2,7,5,3,0,884,0,275,46,0,0,0,12,12,4,10,1,10,14,2,12,10,11,602,8,2,4,4,2,1,4,0,0,4
0,0,2,2,1852,5,103,0,13,0,8,0,1,4,567,5,571,0,20,2,2,41,2192,0,3,150,8,14,1,3,1,2,0,5,3,151,4,2,8,8,0,1,0,0,85,15,2,1,2,10,4,0,0,2,10,4,8,3,3,0,0,3,3,2,1,6,336,13,2,0,2,3,0,0,0,2,10,9,1,5,1,15,0,1,181,0,3,6,0,1,3,0,0,0,2,346
0,5,0,2,2,0,5,0,10,7,0,6,2,0,347,0,0,571,85,0,0,2,8,0,2,0,3,17,0,2,0,2,0,1,5,2,4,4,4,6,2,0,1,46,4,61,74,33,0,0,8,2,457,0,4,1,4,0,268,715,0,2,2,0,1,191,2270,6,0,2,45,104,2,2,3,170,4,0,0,0,4,6,2,8,0,0,0,3,6,0,2,0,0,0,0,371
13,1,523,8,6,4,0,0,3,13,21,2,5,1,9,0,0,5,0,4,8,1,1,1,3,7,9,5,30,0,16,665,11,13,12,10,7,43,131,29,2,1,1,1,3,0,3,0,8,46,104,0,5,5,402,21,1,5,18,6,0,12,8,2,0,4,418,10,0,12,9,11,39,8,2,8,8,43,0,9,0,3,4,0,5,2,2,5,2,2,0,27,0,16,68,0
5,3,631,92,20,6,216,11,2,9,2,2,5,7,0,9,347,567,5,6,16,6,0,4,2,1,0,0,0,0,2,12,10,577,4,2,2,2,11,8,163,0,10,2,0,0,6,6,8,3,20,249,0,4,5,0,6,4,13,6,7,112,6,7,2,18,0,14,3,1,3,0,10,16,122,12,0,0,0,0,0,14,4,7,6,7,8,10,0,0,4,0,0,0,0,1
586,22,3,0,104,12,9,33,8,8,4,5,0,0,7,1,0,4,50,187,6,5,8,2,104,29,1,8,2,14,5,30,0,0,188,13,2,2,8,2,0,2,6,10,0,6,2,2,10,106,2,0,3,0,5,2,2,0,4,6,13,20,57,37,13,2,7,0,0,2,36,4,1,88,20,1,10,8,2,0,185,6,13,0,12,4,8,2,8,0,2,1,7,45,0,16
0,691,56,4,6,0,562,1,0,2,5,4,0,0,5,5,2,1,31,322,4,103,4,6,3,8,1,0,3,0,4,59,3,0,8,19,4,1,3,2,185,7,14,24,2,5,14,7,2,8,2,6,4,7,4,0,51,0,40,4,10,2,2,0,10,391,61,5,84,226,0,48,3,6,14,3,4,2,10,0,0,60,2,66,0,71,1,0,6,8,1021,1,0,0,3,3
0,9,0,0,2,0,12,0,0,3,0,0,4,5,2,2,6,0,22,0,4,0,0,2,4,0,0,2,2,2,12,119,81,8,4,2,3,0,0,70,2,9,10,303,6,11,0,162,0,12,28,0,0,12,0,2,8,0,2,62,0,0,0,2,3,6,48,4,0,2,2,0,2,4,248,3,2,0,0,0,0,0,2,4,76,0,0,0,4,6,0,2,2,0,38,4
4,8,8,0,49,6,1,16,4,6,0,0,5,4,2,21,0,8,2,6,8,1,0,0,14,18,0,0,5,6,5,5,7,0,6,8,21,15,4,7,2,0,13,2,1,181,5,0,0,51,2,3,52,21,224,4,13,3,28,2,5,4,0,10,17,6,0,8,1,8,12,4,44,8,2,2,1,0,0,12,0,24,8,0,98,12,1,12,0,2,1,3,33,252,18,4
0,4,22,4,16,42,20,12,6,0,6,3,2,8,9,13,7,0,2,9,4,18,23,12,3,0,5,2,2,8,0,11,18,6,13,8,19,0,2,2,8,0,10,1,0,8,0,0,2,4,8,21,0,3,3,10,0,4,18,6,9,43,2,4,58,28,2,7,10,16,20,8,10,5,27,534,20,4,6,2,4,12,64,2,511,2,0,5,5,9,22,0,0,21,0,0
70,2,8,2,2,6,8,18,0,6,4,0,0,8,2,3,10,13,0,6,8,2,12,2,35,2,1,4,8,0,146,329,4,4,13,0,4,8,49,3,0,0,4,1,3,0,0,0,5,0,4,40,3,8,4,584,42,7,2,0,0,4,2,2,397,0,68,801,0,19,2,137,3,26,670,9,10,0,0,98,0,10,12,56,2,3,8,10,3,323,3,0,6,6,2,12
1,15,0,1,4,132,0,0,18,12,16,0,1,33,11,0,0,0,6,1,82,16,28,2,83,4,4,16,1,8,26,8,1,6,9,0,28,142,67,5,142,2,1180,10,6,0,0,2,3,5,6,87,2,2,4,147,5,0,12,0,9,320,163,8,8,20,2,13,8,5,0,2,2,2,6,18,0,0,213,0,1,12,0,4,9,16,11,6,4,1,0,0,11,10,0,8
8,303,16,0,9,0,0,0,8,20,1,12,562,9,216,0,5,103,10,10,0,2,0,0,0,0,8,0,3,0,4,2,5,0,16,6,2,2,5,0,4,0,0,0,0,4,2,3,8,22,0,5,4,7,187,2,13,1,30,0,2,1201,0,16,8,301,0,4,252,6,2,1,17,0,29,4,0,2,0,3,0,10,0,51,19,12,39,0,8,8,457,8,0,8,2,1
13,2,0,2,9,0,0,132,6,42,6,0,0,12,6,4,0,5,5,48,146,19,9,28,8,8,350,6,148,572,4,128,61,0,7,0,8,0,6,8,1,6,204,118,6,76,0,1,16,4,3,1,5,2,19,3,16,5,6,2,7,154,18,17,25,8,4,5,2,10,1,123,46,1,6,0,8,6,64,0,2,28,10,16,4,10,14,18,18,18,0,2,335,13,0,12
16,61,1,4,0,9,9,4,2,16,49,2,6,104,20,6,2,1852,12,361,8,0,379,10,4,5,235,18,10,12,15,7,0,0,40,9,55,2,14,11,1,2,12,16,0,4,1,9,3,10,14,385,9,12,21,7,3,21,12,0,1,17,3,5,13,6,5,28,30,5,4,37,38,52,7,14,12,0,13,57,10,10,16,6,10,4,4,52,72,2,144,4,4,4,0,4
4,4,6,0,4,2,0,1,2,4,0,0,4,0,92,8,2,2,14,13,20,0,15,6,7,4,8,0,10,2,942,19,5,0,13,0,2,0,16,35,0,3,9,0,72,2,2,4,10,2,2,13,16,2,1,2,7,8,6,0,5,8,6,0,0,39,6,8,21,18,0,1,259,182,17,21,23,8,20,2,2,8,0,0,9,2,204,8,12,8,4,1,0,2,12,0
0,223,0,6,1,0,16,0,8,22,8,0,56,3,631,523,0,2,2131,5,14,10,8,3,5,16,0,0,4,6,0,272,396,0,10,0,18,10,3,3,97,2,8,24,4,0,7,8,15,1,2,1,5,20,423,0,52,10,0,0,150,16,0,2,6,10,1,301,4,33,0,35,8,3,256,12,4,2,6,5,2,18,4,1972,2,4,108,4,8,7,0,0,113,0,3,24
10,0,223,4,61,2,303,15,2,4,8,9,691,22,3,1,5,0,180,3,34,1091,0,1,22,11,12,6,10,116,0,4,8,0,27,2827,10,0,20,11,4,7,4,13,1,1,4,0,3,0,3,0,8,15,2,0,20,340,5,3,635,8,8,19,2,1255,6,12,1,18,0,5,0,0,3,6,8,7,6,1,0,10,10,6,8,2,10,7,2,6,0,8,2,14,10,16
0,10,0,4,16,13,8,1,70,0,4,0,0,586,5,13,0,0,6,4,5,8,15,1,28,0,8,8,4,9,224,440,16,149,307,0,18,2,32,0,102,8,16,15,220,0,0,0,5,10,0,153,0,0,8,4,322,14,8,4,6,21,127,2,21,15,5,25,1,249,4,2,0,156,0,9,4,3,8,0,24,10,5,4,3,0,2,13,0,8,8,0,4,72,1,0
