5,5,12,2,12,11,3,0,8,0,0,0,8,4,2,1,9,8,18,18,1,6,17,17,4,7,3,2,4,67,0,4,2,4,1,9,3,13,20,3,6,1,4,506,0,8,12,9,6,0,5,2,23,23,3,4,10,4,10,107,10,33,6,13,0,12,6,1,132,14,4,12,0,8,4,18,2,13,16,10,40,2,0,4,4,4,1,5,4,2,8,1,7,8,4,0
7,22,1,2,6,3,0,2,7,2,0,0,10,272,4,1,3,0,294,4,4,10,4,112,4,0,16,10,0,4,11,2,11,8,5,26,14,16,8,0,8,14,0,2,0,7,0,19,17,0,8,2,12,4,1,19,8,0,3,1,8,3,6,0,2,33,10,4,4,6,4,4,324,0,3,23,0,48,66,10,0,4,27,0,60,2,2,60,3,8,8,2,335,8,0,4
4,4,26,2,8,32,19,2,3,416,1,4,8,0,55,0,10,5,10,7,2,12,2,173,40,12,21,5,2,5,17,3,11,9,5,11,4,8,8,29,28,9,0,10,8,0,4,6,18,15,11,10,109,8,2,0,2,8,2,7,6,708,10,9,0,22,16,3,22,6,28,4,10,15,12,5,0,8,22,207,0,4,12,29,8,12,14,6,8,1,0,8,4,0,8,8
0,2,17,0,4,8,108,292,0,10,7,0,3,2,0,0,0,10,12,4,0,4,180,0,2,8,22,0,0,0,8,0,8,0,1,0,23,13,13,8,12,6,8,0,1,11,4,9,6,369,2,0,8,1,0,12,0,2,2,0,608,2,1,21,2,2,4,2,10,2,4,7,1,6,8,327,4,3,7,21,0,2,2,10,9,8,4,233,8,17,0,8,0,4,335,7
10,28,5,10,293,11,14,3,40,3,4,9,6,12,0,0,4,1,10,18,0,8,8,8,25,0,0,0,2,215,3,3,0,11,8,4,4,12,0,18,4,7,0,4,10,12,6,1,10,3,8,229,7,2,4,4,3,9,4,2,22,6,5,11,2,210,20,105,10,7,0,12,8,3,32,5,63,0,18,4,2,16,16,12,20,10,6,0,7,5,3,0,8,8,2,1
4,31,15,3,15,15,0,0,0,0,2,46,6,0,0,0,0,5,0,60,0,3,1,20,0,0,0,2,3,8,7,8,2,172,103,5,4,4,0,18,5,3,0,0,4,56,22,763,8,0,5,11,0,0,0,0,4,23,5,0,0,52,8,0,57,0,86,3,10,3,2,0,6,377,12,2,2,36,1,10,0,0,12,4,194,2,4,25,0,4,0,3,0,0,8,8
0,8,16,4,19,9,5,0,29,16,0,4,0,0,7,305,142,3,4,8,0,2,4,13,16,0,6,9,3,11,16,3,11,7,4,122,10,13,16,16,0,0,0,277,0,18,2,56,8,10,36,2,2,16,0,11,10,0,160,533,15,14,4,2,4,22,12,13,8,4,9,10,3,612,0,1419,0,8,4,10,10,17,2,13,4,7,0,2,15,0,4,5,17,1,8,2
2,0,7,4,2,6,8,1,12,12,4,0,6,2,0,9,4,8,11,10,0,2,4,4,11,4,14,0,588,0,2,0,2,0,14,0,1,16,14,14,22,4,1,226,9,5,0,4,13,2,10,8,3,0,0,3,0,0,1,37,4,3,2,4,1,2,4,570,28,0,10,8,0,0,11,0,0,0,2,12,97,2,10,436,8,0,12,0,0,15,0,7,8,8,3,4
0,8,9,13,0,4,7,0,17,2,0,28,5,0,0,230,0,2,1,16,2,6,4,0,0,4,2,0,0,4,8,0,34,0,6,4,32,2101,6,10,0,0,2,14,0,0,6,6,15,0,4,4,2,0,4,0,0,158,1,2,0,9,2,2,3,340,5,0,2,1,12,1094,31,5,0,1,0,0,8,13,3,2,8,6,14,4,15,0,0,2,25,0,233,6,60,5
2,10,0,4,5,11,2,0,4,0,0,0,12,2,2,0,5,0,4,14,6,13,1,0,127,8,0,2,0,10,20,25,0,8,7,8,0,16,2,4,0,6,11,5,8,4,0,6,0,9,2,8,0,8,5,15,0,2,0,5,0,2,9,14,8,0,7,8,0,0,9,2,8,7,0,0,0,8,0,16,4,1,0,12,12,4,0,15,12,0,4,6,4,14,2,1
4,7,16,12,4,10,9,3,6,3,27,4,16,13,2,0,8,34,116,15,3,0,5,2,0,2,0,0,0,4,37,4,6,19,7,4,2,6,8,19,29,2,20,6,1,8,11,21,24,8,2,19,4,15,1,8,5,4,6,26,153,10,9,7,4,1,25,12,12,2,0,40,2,16,15,3,78,4,14,10,49,2,6,11,4,0,4,4,0,7,2,10,8,12,2,4
12,27,5,2,21,6,16,4,16,28,2,2,10,6,0,0,1,12,44,8,8,4,5,6,17,2,4,0,2,0,11,0,2,16,0,2,14,13,8,8,28,12,8,6,1,12,12,20,12,0,23,6,14,4,24,17,12,0,0,3,1,4,14,1,4,4,2,16,20,8,0,8,2,12,2,11,73,21,24,26,0,27,12,8,0,4,12,14,8,4,194,20,9,8,60,4
1,3,854,10,14,15,201,0,583,4,12,6,12,24,16,395,14,7,20,34,6,1,5,8,9,3,12,0,2,2,18,5,9,236,15,22,9,12,2,10,403,656,1,4,16,26,9,4,17,5,10,9,2,0,6,10,5,4,2,13,2,8,4,12,1,96,7,4,27,8,30,4,1,14,10,9,68,10,42,12,2,15,26,0,8,11,12,6,436,13,4,12,10,29,0,4
4,13,21,0,10,8,5,0,0,15,4,0,20,0,0,2,30,103,8,0,8,272,6,25,10,4,4,4,9,2,28,12,16,344,0,13,141,20,6,21,16,14,0,201,6,12,8,40,218,12,22,4,302,0,4,10,0,16,9,1,330,1,12,8,3,767,21,0,2,0,353,3,8,17,15,20,0,20,40,14,30,0,0,26,12,6,0,8,10,2,12,16,2,12,27,0
1,3,4,8,217,12,2,0,37,4,14,36,0,0,12,0,7,8,4,17,0,8,5,0,0,4,2,0,0,8,1,6,11,77,7,8,0,6,4,4,20,20,0,2,4,398,6,18,20,1,0,3,1,14,0,22,1,6,3,1,0,2,0,10,2,22,15,10,4,0,8,4,5,2,14,6,106,4,36,12,4,0,0,15,27,2,1,2,2,17,0,16,2,4,4,2
0,2,8,52,179,62,2,133,6,8,1,0,16,350,8,116,53,178,0,4,95,0,2,0,6,30,6,3,12,2,0,6,19,4,2,1,14,6,3,7,5,0,2,539,2,2,2,2,180,1,13,9,4,2,96,6,52,6,3,167,20,4,5,6,0,8,5,8,2,0,0,2,4,206,16,32,2,0,2,9,0,4,30,2,0,49,4,3,97,10,0,2,0,0,0,40
2,6,8,4,4,12,12,2,292,8,2,0,0,114,0,0,0,21,17,122,0,272,8,4,91,10,22,4,12,0,8,12,105,8,64,5,4,14,6,9,62,20,8,0,12,18,6,918,6,4,7,2,21,8,2,5,12,2,615,3,20,2,1,72,3,2,19,4,16,14,26,5,2,14,6,5,4,10,28,0,9,12,14,12,26,10,16,13,12,10,10,4,21,207,10,10
3,8,10,4,2,9,0,3,11,8,67,2,14,3,4,2,12,4,19,8,0,8,0,18,9,5,2,3,6,796,14,5,24,2,6,9,4,31,2,22,29,10,2,2,0,30,10,12,25,23,17,160,0,2,0,24,8,3,1,2,4,13,10,7,8,53,16,13,12,6,8,142,2,6,19,2,8,0,0,28,2,36,40,42,24,14,0,8,2,4,1,18,7,22,66,16
7,2,11,10,22,28,23,0,10,0,0,0,20,0,7,2,0,12,4,0,0,24,10,7,6,2,4,2,2,0,14,8,4,11,8,12,0,12,10,10,2,2,0,5,2,5,4,8,16,0,3,16,546,5,3,0,1,0,3,14,3,4,0,29,2,4,14,0,121,3,0,6,4,14,14,995,6,0,0,10,0,4,20,10,21,4,8,0,0,8,36,0,3,8,48,13
508,2,6,8,2,50,8,1,6,2,17,0,2,0,8,47,4,3,0,0,0,0,2,4,1,1,33,10,2,15,6,0,6,0,57,4,0,8,0,50,8,18,0,15,8,6,0,279,6,0,8,13,14,4,2,5,2,6,54,0,457,0,21,196,2,4,3,4,0,2,4,2,1,4,11,4,0,6,8,4,2,106,0,68,73,78,0,0,0,0,2,63,4,0,0,2
1,16,4,15,8,19,0,2,2,445,0,3,11,51,31,4,3,10,0,0,2,4,0,536,5,0,1,3,4,1654,2,455,4,2,2,12,1,4,3,14,18,13,0,1,4,2,2,8,6,5,6,2,2,19,2,12,5,0,8,4,2,2,0,8,0,10,8,4,8,8,0,12,0,621,6,0,4,995,2,5,32,6,20,9,11,3,0,1,0,1419,2,5,327,5,23,18
8,45,17,8,7,7,10,2,4,12,0,2,12,233,12,5,5,8,160,11,0,93,1,10,7,6,7,8,2,3,6,2,4,13,4,2,0,22,6,6,572,358,2,8,4,28,247,20,8,0,8,10,12,0,9,2,4,117,7,4,25,2,9,14,0,41,14,44,8,24,2,17,2,12,0,6,11,14,19,6,16,14,15,10,2,15,0,0,11,0,12,32,8,12,3,4
6,186,9,4,6,20,13,0,2,66,0,0,53,43,16,4,1747,6,14,12,0,2,8,20,4,4,7,1,0,0,26,2,10,0,29,8,0,12,22,62,3,11,4,309,0,52,2,150,14,14,0,405,8,0,0,1,8,4,4,1,8,1080,14,14,5513,4,2,10,20,105,413,8,1,0,12,621,4,14,6,14,206,2,17,14,12,16,7,5,0,612,377,3,6,15,0,8
10,0,12,2,2,10,8,74,4,0,3,161,0,261,1,1,1,8,8,2,1,0,0,12,0,6,5,2,0,16,2,9,0,0,3,2,1,2,2,0,467,4,0,2,0,0,8,6,3,0,0,4,1,8,3,2,0,79,4,3,300,2,12,0,0,8,0,2,35,0,1,0,0,1,2,0,1,4,2,2,4,5,8,1,2,2,8,31,0,3,6,8,1,10,324,0
0,10,7,0,4,11,3,0,2,9,622,2,2,28,5,2,36,16,8,37,2,68,14,6,12,0,1,12,11,3,22,3,36,0,8,12,15,0,0,904,16,3,0,20,0,13,1,11,14,0,14,13,8,7,0,437,0,0,11,13,4,1,20,4,0,5,45,8,799,13,6,0,0,8,17,12,2,6,142,5,2,4,3,4,8,40,2,1094,8,10,0,12,7,4,4,12
0,4,0,0,12,12,0,0,4,2,1010,0,3,0,4,4,110,1953,16,4,2,1,8,2,15,12,6,2,0,0,2,4,5,0,0,10,4,27,0,60,20,4,5,224,7,2,13,19,3,0,424,8,0,2,0,2,0,6,11,5,0,51,0,3,4727,5,5,9,114,0,0,6,1,413,2,0,4,0,8,26,0,8,353,30,0,0,9,12,10,9,2,0,4,28,4,4
8,10,19,10,1,12,4,73,2,34,0,0,12,42,5,0,8,5,2,4,1,2,0,2,0,2,1,2,0,25,4,1,540,1,2,8,0,2,8,2,0,12,4,4,4,16,0,4,10,13,265,16,4,2,0,1,2,8,4,2,2,4,2,8,0,0,33,0,16,0,0,13,0,105,24,8,2,3,6,14,0,0,0,8,8,2,0,1,0,4,3,7,2,6,6,14
15,17,5,2,13,18,8,89,0,8,12,0,4,8,25,2,6,9,31,5,131,7,9,19,5,10,2,0,1,1,14,5,11,2,6,2,2,28,2,21,9,15,8,2,8,14,6,18,152,2,10,6,4,8,2,9,8,6,20,4,2,2,2,230,2,3,21,6,0,16,114,799,35,20,8,8,0,121,12,16,2,4,2,27,20,12,0,2,28,8,10,10,10,22,4,132
2,37,4,18,55,366,10,5,30,38,3,8,0,8,4,0,25,2,11,3,4,0,2,8,7,76,0,2,3,6,6,1,0,8,4,9,0,23,6,25,4,29,8,15,3,11,4,20,19,6,2,8,7,0,5,6,0,1,3,4,4,0,1,3,0,6,14,0,6,0,9,8,2,10,44,4,4,0,13,4,8,10,0,4,16,12,8,0,570,13,3,105,2,3,4,1
2,0,34,6,0,992,16,4,6,10,7,0,2,36,4,9,0,17,8,36,2,8,5,25,10,9,4,401,0,1,17,12,2,5,22,16,11,14,6,22,1,18,3,0,3,8,0,151,5,4,1,22,7,8,0,4,0,0,190,7,8,2,338,0,0,158,0,14,21,33,5,45,0,2,14,8,3,14,16,19,5,15,21,7,2,25,7,5,4,12,86,20,4,16,10,6
151,10,26,6,494,2,107,4,46,7,4,0,7,5,66,4,13,6,25,12,0,5,6,13,0,10,7,6,2,8,20,0,10,11,0,17,102,4,1,8,387,27,3,69,9,60,10,14,7,8,8,4,9,0,0,4,12,1,5,0,4,6,4,119,2,0,158,6,3,0,5,5,8,4,41,10,4,4,53,2,8,22,767,96,4,1,0,340,2,22,0,210,2,22,33,12
0,6,4,0,0,0,12,0,2,0,0,10,0,338,2,55,2056,4,4,4,1,784,4,5,0,4,2,12,0,2,11,0,2,0,0,6,695,2,3,0,4,0,259,556,6,5,2,187,2,20,4,0,10,30,4,2,0,0,2,58,0,1637,6,2,0,2,0,0,2,0,4727,0,0,5513,0,0,2,2,8,3,0,2,3,1,4,4,8,3,1,4,57,2,2,0,2,0
4,10,16,2,13,2,20,0,0,4,8,0,11,11,3,3,4,0,10,16,1,0,16,1,35,0,25,0,2,8,2,8,0,1,59,8,3,26,14,8,10,30,0,4,5,423,6,8,14,2788,90,4,5,0,4,18,2,19,1,4,0,5,4,0,2,119,0,3,230,8,3,4,0,14,14,8,196,29,7,72,6,10,8,12,1,7,14,2,4,2,0,11,21,9,0,13
4,0,10,6,6,4,10,0,6,0,59,2,6,8,6,10,2,18,10,16,0,0,12,4,12,2,25,218,2,28,17,0,0,4,0,1,8,4,8,12,2,1,2,10,4,4,2,7,2,0,0,6,12,0,1,6,1,5,27,0,0,8,0,4,6,4,338,1,2,2,0,20,12,14,9,0,21,0,10,1,5,0,12,4,14,9,9,2,2,4,8,5,1,10,6,6
4,0,6,0,7,0,11,4,120,5,4,60,1,8,0,4,1297,5,1,2,5,1,0,8,31,8,4,1866,6,122,24,0,6,8,2,0,4,4,2,3,2,3,10,0,0,0,2,125,2,2,4,2,1522,1,0,2,4,23,5,65,2,0,8,5,1637,6,2,0,2,4,51,1,2,1080,2,2,0,4,13,2,4,2,1,8,4,10,2,9,3,14,52,6,2,708,3,33
0,9,9,6,163,13,299,72,2,4,2,38,1,5,1,2,2,9,0,2,0,0,0,4,43,122,16,37,29,0,3,2,4,0,139,2,80,12,4,3,3,14,0,18,0,0,36,2,7,3720,2,11,16,0,348,10,9,3,0,14,0,2,0,0,0,4,8,4,2,2,0,4,300,8,25,2,457,3,4,20,20,0,330,2,1,153,0,0,4,15,0,22,608,6,8,10
1330,2,6,0,4,6,2,3,4,2,5,21,2,12,2,1618,1,22,6,8,0,2,0,3,6,8,1,0,1,7,16,10,10,67,4,2,2,10,606,28,0,1,0,189,0,11,3,2,4,0,70,4,6,0,0,6,0,8,69,0,14,65,0,4,58,0,7,4,4,2,5,13,3,1,4,4,0,14,2,3,167,1,1,13,3,26,5,2,37,533,0,2,0,7,1,107
4,8,13,4,12,15,11,0,15,16,20,2,5,10,4,66,4,12,2,5,1151,4,0,0,12,6,26,8,1,12,4,0,6,16,9,2,18,10,14,10,2,8,16,32,3,0,2,3,72,8,11,13,19,0,0,39,1,3,0,69,0,5,27,1,2,5,190,3,20,4,11,11,4,4,7,8,54,3,1,615,3,3,9,2,0,6,0,1,1,160,5,4,2,2,3,10
1,0,2,0,4,15,0,69,3,0,3,70,3,5,0,12,12,10,4,5,0,3,0,0,0,4,12,4,1,1,2,2,0,0,460,9,0,2,20,4,3,0,2,214,1,2,4,4,8,0,4,2,0,4,1,6,0,0,3,8,3,23,5,19,0,1,0,1,6,8,6,0,79,4,117,0,6,0,3,2,6,6,16,4,0,4,2,158,0,0,23,9,2,8,0,4
18,1,140,88,1,3,0,7,0,5,1,0,7,145,13,0,0,8,0,3,32,1,5,12,0,50,16,1,4,10,343,4,0,2,1,0,4,1,0,6,0,2,0,1434,9,0,37,0,4,8,0,10,13,8,42,9,0,0,1,0,9,4,1,2,0,12,0,0,8,2,0,0,0,8,4,5,2,1,8,12,52,1,0,5,12,5,0,0,0,10,4,3,0,2,8,10
4,0,7,0,2,396,5,5,2,2,4,0,2,2,8,0,1,7,0,0,7,16,5,0,4,1,187,1,336,2,4,1,15,8,15,15,6,8,2,20,2,8,3,633,2,4,0,7,15,11,0,5,6,0,1,0,9,6,39,6,10,2,6,18,2,4,4,6,9,1,2,437,2,1,2,12,5,0,24,5,6,22,10,10,17,8,15,0,3,11,0,4,12,0,19,4
6,0,10,23,755,0,4,48,0,0,1,8,0,0,0,4,4,2,2,0,4,0,1,4,10,25,0,23,29,0,0,0,0,0,20,0,6,4,8,2,0,2,0,0,0,0,68,0,21,0,2,37,2,0,0,1,42,1,0,0,348,0,1,4,4,0,0,5,2,0,0,0,3,0,9,2,2,3,0,2,96,0,4,6,24,1,5,4,0,0,0,4,0,2,1,3
4,1,93,145,3,23,4,0,3,175,0,0,0,1017,11,0,602,1,1,0,0,9,12,0,0,0,8,0,0,7,3,0,20,0,0,0,0,2,5,8,201,0,1,0,0,1,4,8,73,9,0,8,2,0,0,0,8,4,0,0,0,1,0,0,30,0,8,0,8,2,2,7,8,0,0,19,4,5,2,8,2,14,0,0,4,15,8,0,0,16,0,2,1,8,4,23
12,6,4,4,0,12,4,0,15,0,13,0,4,6,8,2,8,16,2,6,12,4,10,545,4,2,1,6,10,0,7,4,56,252,0,10,1,2,17,22,4,24,175,7,2,12,2,12,8,115,2,683,0,2,2,6,13,0,19,6,16,1522,12,5,10,9,7,7,4,4,0,8,1,8,12,2,14,546,0,21,4,1,302,2,14,4,0,2,3,2,0,7,8,109,12,23
444,6,6,7,7,4,5,2,1846,0,2,0,16,3,13,5,20,6,0,5,1,2,0,12,70,139,4,70,6,60,4,2,90,3,9,0,4,11,9,5,7,12,14,6,3273,2,30,11,12,1,14,0,683,8,37,5,10,2,13,4,11,2,6,4,0,4,22,8,6,16,8,13,4,405,10,2,13,16,160,2,9,3,4,9,6,19,8,4,8,2,11,229,0,10,2,2
10,6,4,2,0,23,23,8,0,2,283,0,6,0,26,93,0,5,6,6,4,226,8,2,9,2,6,0,10,0,140,0,359,6,4,10,6,10,12,8,612,153,16,2,2,3,77,2,6,3,0,14,2,0,2,0,0,4,11,70,2,4,0,90,4,8,1,2,10,265,424,14,0,0,8,6,8,3,17,7,13,0,22,10,23,2,2,4,10,36,5,8,2,11,8,5
4,6,11,2,8,16,124,7,2,37,0,8,11,11,4,5,5,0,0,2,5,0,2,143,169,380,15,0,8,6,6,6,6,4,4,0,275,0,1,5,4,0,0,0,5,12,2,2,18,0,3,1,115,9,0,11,8,0,8,0,3720,2,0,2788,20,8,4,6,2,13,0,0,0,14,0,5,0,0,23,4,1,1,12,5,0,8,9,0,2,10,0,3,369,15,0,0
19,11,13,6,7,23,16,8,8,6,2,3,129,32,0,0,6,6,3,12,0,7,7,18,10,5,13,36,11,2,16,17,24,10,6,12,2,15,2,17,23,5,10,10,2,8,30,173,0,18,6,12,8,73,21,15,4,8,72,4,7,2,2,14,2,7,5,19,152,10,3,14,3,14,8,6,6,16,25,6,180,20,218,17,12,24,0,15,13,8,8,10,6,18,17,6
0,10,0,4,2,12,4,10,2,15,14,8,6,0,18,2,20,220,9,10,8,13,12,8,4,4,6,9,0,0,24,2,2,14,4,15,5,6,8,16,12,9,8,362,4,11,8,0,173,2,2,11,12,8,0,7,0,4,3,2,2,125,7,8,187,14,151,20,18,4,19,11,6,150,20,8,279,8,12,918,2,18,40,4,20,21,6,6,4,56,763,1,9,6,19,9
5,5,10,24,2,7,2,2,0,0,4,0,4,325,0,0,4,71,8,0,6,6,2,2,696,30,6,3,28,20,7,2,10,2,27,2,29,4,2,2,4,8,2,186,0,77,0,8,30,2,77,30,2,4,68,0,37,4,2,3,36,2,2,6,2,10,0,4,6,0,13,1,8,2,247,2,0,4,10,6,2,6,8,9,12,11,0,6,0,2,22,6,4,4,0,12
3,16,6,8,0,20,2,2,8,5,5,0,9,36,3,0,438,377,16,0,12,806,1,9,0,2,5,1,4,12,16,6,4,20,0,0,4,16,4,15,7,7,8,1,4,0,77,11,8,12,3,2,12,1,0,4,0,2,0,11,0,0,4,423,5,60,8,11,14,16,2,13,0,52,28,2,6,5,30,18,2,398,12,26,12,8,4,0,5,18,56,12,11,0,7,8
17,3,1,1,9,0,0,0,2643,0,0,0,0,2,11,8,0,0,0,4,10,0,4,2,8,421,0,3,2,323,4,0,14,24,1,1,1,16,12,4,2,12,4,4,0,4,0,4,2,5,2,3273,2,0,0,2,9,1,3,0,0,0,4,5,6,9,3,3,8,4,7,0,0,0,4,4,8,2,0,12,2,4,6,16,1,1,8,0,9,0,4,10,1,8,0,0
0,2,10,1,8,8,1,0,9,8,0,0,6,10,0,279,11,496,0,3,76,0,2,1,16,0,15,2,2,12,1525,3,0,0,10,10,3,8,1,357,0,0,3,0,4,1,186,362,10,0,2,6,7,0,0,633,1434,214,32,189,18,0,10,4,556,69,0,15,2,4,224,20,2,309,8,1,15,5,2,0,539,2,201,4,6,6,5,14,226,277,0,4,0,10,2,506
0,8,2,0,2,0,4,0,0,10,6,0,5,9,1,2,0,13,2,0,20,3,1,1,4,4,0,0,0,2,13,2,12,0,4,1,9,17,8,4,92,2,0,3,4,8,2,8,10,0,16,14,175,1,0,3,0,2,16,0,0,10,2,0,259,3,3,8,8,4,5,0,0,4,2,0,0,0,2,8,2,0,0,1,8,20,11,2,1,0,0,0,8,0,0,4
13,4,7,2,0,9,8,0,19,6,3,2,5,351,6,2,1,8,0,10,296,49,1,2575,3,4,0,2,2,0,2,368,4,9,3,20,0,6,9,34,2734,0,2,0,12,7,8,9,5,0,153,12,24,0,2,8,2,0,8,1,14,3,1,30,0,27,18,29,15,12,4,3,4,11,358,13,18,2,10,20,0,20,14,656,12,2,6,0,4,0,3,7,6,9,14,1
4,10,34,7,8,8,196,2,4,8,980,0,8,11,468,0,94,3,15,4,571,95,1,4,4,4,6,0,4,0,6,0,32,2,4,10,274,19,1,4,0,2734,92,0,2,7,4,12,23,4,612,7,4,201,0,2,0,3,2,0,3,2,2,10,4,387,1,4,9,0,20,16,467,3,572,18,8,2,29,62,5,20,16,403,28,29,0,0,22,0,5,4,12,28,8,6
0,8,28,2,0,4,19,0,22,14,151,0,13,0,0,5,1,27,0,4,5,26,8,163,10,4,10,0,9,10,8,11,2,4,2,18,11,22,2,0,4,34,4,357,4,15,2,16,17,5,8,5,22,8,2,20,6,4,10,28,3,3,12,8,0,8,22,25,21,2,60,904,0,62,6,14,50,10,22,9,7,4,21,10,8,19,4,10,14,16,18,18,8,29,0,3
0,261,13,11,10,6,599,88,8,5,0,3,10,5,8,2,2,9,0,4,8,0,17,20,12,12,8,0,2,1,4,4,6,5,0,5,16,2,0,2,1,9,8,1,12,4,2,8,2,1,12,9,17,5,8,2,0,20,14,606,4,2,8,14,3,1,6,6,2,8,0,0,2,22,6,3,0,10,2,6,3,4,6,2,8,8,2,6,14,16,0,0,13,8,8,20
3,24,8,2,3,16,16,8,14,17,2,2,16,15,6,4,12,10,23,10,2,10,14,6,1,12,2,6,1,2,33,9,10,28,18,17,64,0,2,22,19,6,17,8,16,16,4,6,15,0,10,11,2,2,4,8,1,2,10,10,12,4,4,26,2,4,14,23,28,2,27,0,2,12,22,4,8,12,31,14,6,6,20,12,13,6,16,2101,16,13,4,12,13,8,16,13
8,0,2,17,0,0,322,8,6,6,1,2,10,228,1,6,4,0,2,2,585,2,0,16,10,31,8,8,8,10,0,0,2,2,30,0,0,64,16,11,274,0,9,3,1,4,29,5,2,275,6,4,1,0,6,6,4,0,18,2,80,4,8,3,695,102,11,0,2,0,4,15,1,0,0,1,0,0,4,4,14,0,141,9,14,2,0,32,1,10,4,4,23,4,14,3
4,4,17,12,15,8,464,0,10,14,3,1,2,5,12,1,8,10,47,1,0,12,4,0,18,0,2,2,0,10,4,28,12,6,3,0,0,17,5,18,10,20,1,10,1,0,2,15,12,0,10,0,10,0,0,15,0,9,2,2,2,0,1,8,6,17,16,9,2,8,10,12,2,8,2,12,4,12,9,5,1,8,13,22,2,4,8,4,0,122,5,4,0,11,26,9
5,18,16,18,143,16,14,0,6,0,16,0,28,10,12,0,3,379,2,10,206,2,0,0,2,38,254,6,0,0,8,4,8,4,0,3,30,18,0,2,4,3,4,10,1,0,27,4,6,4,4,9,0,0,20,15,1,460,9,4,139,2,0,59,0,0,22,4,6,2,0,8,3,29,4,2,57,8,6,64,2,7,0,15,0,7,7,6,14,4,103,8,1,5,5,1
5,8,9,15,11,96,16,4,22,12,1,4,4,17,10,3,28,12,12,0,64,8,0,6,2,6,0,6,0,6,3,6,0,0,4,6,2,28,5,4,2,9,0,0,24,20,2,14,10,4,6,3,252,0,0,8,2,0,16,67,0,8,4,1,0,11,5,8,2,1,0,0,0,0,13,2,0,11,2,8,4,77,344,236,16,19,8,0,0,7,172,11,0,9,8,4
0,14,7,0,0,12,10,0,4,0,4,1,2,0,4,8,1,27,15,4,0,20,4,6,8,3,157,0,4,4,8,11,0,0,8,12,2,10,6,2,32,4,12,0,14,4,10,2,24,6,359,90,56,20,0,15,0,0,6,10,4,6,0,0,2,10,2,0,11,540,5,36,0,10,4,4,6,4,24,105,19,11,16,9,2,6,0,34,2,11,2,0,8,11,11,2
10,1,2,24,5,8,4,0,2,3,0,3,2,6,4,0,0,4,10,12,0,5,12,2,131,5,8,2,10,835,13,0,11,6,4,28,0,9,4,11,0,368,2,3,0,6,2,2,17,6,0,2,4,0,0,1,4,2,0,10,2,0,0,8,0,0,12,1,5,1,4,3,9,2,2,455,0,8,5,12,6,6,12,5,0,4,25,0,0,3,8,3,0,3,2,4
9,2,5,4,23,18,3,0,23,0,8,2,8,10,10,5,14,29,9,27,0,11,4,8,16,16,1,4,6,6,0,13,8,3,8,4,0,33,4,8,6,2,13,1525,4,16,7,24,16,6,140,4,7,3,0,4,343,2,4,16,3,24,17,2,11,20,17,6,14,4,2,22,2,26,6,2,6,14,14,8,0,1,28,18,11,37,20,8,2,16,7,3,8,17,11,0
4,18,14,31,302,4,12,2,11,714,25,12,4,6,8,581,1,0,124,2,3,3,1,12,331,5,26,4,0,0,6,835,4,6,0,10,10,2,1,10,0,0,2,12,323,12,20,0,2,6,0,60,0,7,0,2,10,1,12,7,0,122,28,8,2,8,1,6,1,25,0,3,16,0,3,1654,15,0,796,0,2,8,2,2,0,4,10,4,0,11,8,215,0,5,4,67
8,7,0,7,1,0,1,5,4,2,0,0,0,0,0,2,0,4,0,0,5,5,0,1,2,7,97,28,0,0,6,10,4,0,0,0,8,1,2,9,4,2,0,2,2,4,28,0,11,8,10,6,10,0,29,336,4,1,1,1,29,6,2,2,0,2,0,3,1,0,0,11,0,0,2,4,2,2,6,12,12,0,9,2,2,0,0,0,588,3,3,2,0,2,0,4
5,1,7,5,8,204,0,30,43,0,0,0,0,0,2,0,2,699,2,8,1,3,2,6,0,0,4,0,28,4,4,2,0,6,6,2,8,6,0,0,0,2,0,2,3,1,3,9,36,0,0,70,6,0,23,1,1,4,8,0,37,1866,218,0,12,6,401,2,0,2,2,12,2,1,8,3,10,2,3,4,3,0,4,0,0,0,2,0,0,9,2,0,0,5,10,2
0,5,3,10,0,10,16,0,5,68,0,2,5,4,8,0,0,9,4,10,355,1,8,5,14,6,0,4,97,26,1,8,157,0,254,2,8,2,8,10,6,0,0,15,0,5,6,6,13,15,6,4,1,8,0,187,16,12,26,1,16,4,25,25,2,7,4,0,2,1,6,1,5,7,7,1,33,4,2,22,6,2,4,12,4,0,0,2,14,6,0,0,22,21,16,3
0,0,10,9,0,33,9,3,121,0,2,0,10,0,0,8,0,0,0,4,35,4,2,4,2,0,6,0,7,5,16,5,3,6,38,0,31,12,12,4,4,4,4,0,421,2,30,4,5,380,2,139,2,0,25,1,50,4,6,8,122,8,2,0,4,10,9,76,10,2,12,0,6,4,6,0,1,2,5,10,30,4,4,3,2,2,8,4,4,0,0,0,8,12,0,7
0,6,7,3,19,29,16,8,2,6,0,4,9,0,26,11,0,2,4,13,9,4,24,12,0,2,14,0,2,331,16,131,8,2,2,18,10,1,12,10,4,3,4,16,8,0,696,4,10,169,9,70,4,0,10,4,0,0,12,6,43,31,12,35,0,0,10,7,5,0,15,12,0,4,7,5,1,6,9,91,6,0,10,9,17,0,127,0,11,16,0,25,2,40,4,4
4,34,10,14,0,10,15,0,4,40,0,45,22,98,1,0,166,13,2,7,3,488,4,0,12,4,5,6,1,12,8,2,6,6,0,0,16,6,20,163,4,2575,1,1,2,9,2,8,18,143,2,12,545,0,4,0,12,0,0,3,4,8,4,1,5,13,25,8,19,2,2,6,12,20,10,536,4,7,18,4,0,0,25,8,6,2,0,0,4,13,20,8,0,173,112,17
186,0,4,1,254,0,10,0,5,6,0,2,8,8,4,2,0,2,0,80,1,2,0,4,24,2,8,2,0,1,4,12,4,0,0,4,0,14,17,8,1,1,1,2,4,1,2,12,7,2,8,0,10,12,1,5,5,0,0,0,0,0,12,16,4,6,5,2,9,0,8,14,0,8,1,0,2,10,0,8,2,5,6,5,5,5,1,4,4,4,1,8,180,2,4,17
0,4,2,4,6,2,2,2,11,2,27,0,2,374,22,0,3,14,1,2,0,0,2,488,4,4,1,3,5,3,11,5,20,8,2,12,2,10,0,26,95,49,3,0,0,806,6,13,7,0,226,2,4,9,0,16,1,3,4,2,0,1,0,0,784,5,8,0,7,2,1,68,0,2,93,4,0,24,8,272,0,8,272,1,4,0,13,6,2,2,3,8,4,12,10,6
0,8,3,2,1,10,2,0,0,0,924,0,0,0,0,4,0,157,0,5,0,0,1,3,9,35,355,1,5,3,0,0,0,64,206,0,585,2,8,5,571,296,20,76,10,12,6,8,0,5,4,1,12,0,4,7,32,0,1151,0,0,5,0,1,1,0,2,4,131,1,2,2,1,0,0,2,0,0,0,0,95,0,8,6,8,3,6,2,0,0,0,0,0,2,4,1
0,4,3,4,8,2,2,0,8,76,10,0,3,40,9,0,8,4,0,0,5,2,80,7,13,4,10,8,0,2,27,12,4,0,10,1,2,10,4,4,4,10,0,3,4,0,0,10,12,2,6,5,6,0,0,0,3,5,5,8,2,2,16,16,4,12,36,3,5,4,4,37,2,12,11,0,0,0,8,122,4,17,0,34,8,15,14,16,10,8,60,18,4,7,4,18
4,91,0,3,8,16,256,2,6,2,288,2,4,2,10,2,0,5,0,0,0,1,0,2,4,0,4,2,0,124,9,10,15,12,2,47,2,23,0,0,15,0,2,0,0,16,8,9,3,0,6,0,2,1,2,0,0,4,2,6,0,1,10,10,4,25,8,11,31,2,16,8,8,14,160,0,0,4,19,17,0,4,8,20,44,116,4,1,11,4,0,10,12,10,294,18
6,0,4,2,0,21,8,5,21,9,27,0,2,2,4,0,81,0,5,4,157,14,2,13,2,0,9,699,4,0,29,4,27,12,379,10,0,10,9,27,3,8,13,496,0,377,71,220,6,0,5,6,16,1,2,7,8,10,12,22,9,5,18,0,4,6,17,2,9,5,1953,16,8,6,8,10,3,12,4,21,178,8,103,7,12,34,0,2,8,3,5,1,10,5,0,8
2,0,47,9,14,16,4,0,2,10,0,6,21,6,6,1,0,81,0,8,0,3,0,166,0,0,0,2,0,1,14,0,1,28,3,8,4,12,2,1,94,1,0,11,0,438,4,20,6,5,0,20,8,602,4,1,0,12,4,1,2,1297,2,4,2056,13,0,25,6,8,110,36,1,1747,5,3,4,0,12,0,53,7,30,14,1,8,5,0,4,142,0,4,0,10,3,9
0,0,5,2,1163,4,0,83,4,1,7,4,10,1,0,0,1,0,2,0,4,0,2,0,11,8,0,0,2,581,5,0,8,3,0,1,6,4,2,5,0,2,2,279,8,0,0,2,0,5,93,5,2,0,4,0,0,12,66,1618,2,4,10,3,55,4,9,0,2,0,4,2,1,4,5,4,47,2,2,0,116,0,2,395,0,0,0,230,9,305,0,0,0,0,1,1
5,10,9,3,12,36,8,10,337,4,193,0,119,2,0,0,6,4,10,9,0,22,4,1,26,0,8,2,0,8,10,4,4,10,12,12,1,6,8,0,468,6,1,0,11,3,0,18,0,4,26,13,8,11,0,8,13,0,4,2,1,0,6,3,2,66,4,4,25,5,4,5,1,16,12,31,8,7,4,0,8,12,0,16,0,2,2,0,0,7,0,0,0,55,4,2
4,12,1,12,8,2,1,2,3,362,17,6,12,0,2,1,6,2,2,40,0,374,8,98,0,0,4,0,0,6,10,6,0,17,10,5,228,15,5,0,11,351,9,10,2,36,325,0,32,11,0,3,6,1017,0,2,145,5,10,12,5,8,8,11,338,5,36,8,8,42,0,28,261,43,233,51,0,0,3,114,350,0,0,24,6,13,2,0,2,0,0,12,2,0,272,4
6,2,15,4,17,5,182,4,565,57,1,0,0,12,119,10,21,2,4,3,0,2,8,22,9,10,5,0,0,4,8,2,2,4,28,2,10,16,10,13,8,5,5,6,0,9,4,6,129,11,6,16,4,0,0,2,7,3,5,2,1,1,6,11,0,7,2,0,4,12,3,2,0,53,12,11,2,20,14,0,16,0,20,12,10,16,12,5,6,0,6,6,3,8,10,8
0,1,4,7,8,8,1,14,10,3,3,0,0,6,0,4,6,0,2,0,0,0,2,45,4,0,2,0,0,12,2,3,1,4,0,1,2,2,3,0,0,2,0,0,0,0,0,8,3,8,0,0,0,0,8,0,0,70,2,21,38,60,2,0,10,0,0,8,0,0,0,2,161,0,2,3,0,0,2,0,0,36,0,6,2,4,0,28,0,4,46,9,0,4,0,0
0,4,4,0,0,4,0,1,0,0,0,3,1,17,193,7,0,27,288,10,924,27,0,0,0,2,0,0,0,25,8,0,4,1,16,3,1,2,0,151,980,3,6,0,0,5,4,14,2,0,283,2,13,0,1,4,1,3,20,5,2,4,59,8,0,4,7,3,12,0,1010,622,3,0,0,0,17,0,67,2,1,14,4,12,2,27,0,0,4,0,2,4,7,1,0,0
0,4,1057,6,10,4,0,1,16,0,0,3,57,362,4,1,10,9,2,76,0,2,6,40,6,0,68,0,2,714,0,3,0,12,0,14,6,17,5,14,8,6,10,8,0,5,0,15,6,37,2,0,0,175,0,2,5,0,16,2,4,5,0,4,0,7,10,38,8,34,2,9,0,66,12,445,2,0,8,8,8,4,15,4,28,3,0,2,12,16,0,3,10,416,2,0
2,16,0,3,15,14,11,0,0,16,0,10,565,3,337,4,2,21,6,8,0,11,5,4,2,121,5,43,4,11,23,2,4,22,6,10,6,14,8,22,4,19,0,9,2643,8,0,2,8,2,0,1846,15,3,0,2,0,3,15,4,2,120,6,0,2,46,6,30,0,2,4,2,4,2,4,2,6,10,11,292,6,37,0,583,16,6,4,17,12,29,0,40,0,3,7,8
0,0,10,2,4,3,838,0,0,1,1,14,4,2,10,83,0,5,2,0,0,2,0,0,8,3,0,30,5,2,0,0,0,4,0,0,8,8,88,0,2,0,0,0,0,2,2,10,8,7,8,2,0,0,48,5,7,69,0,3,72,4,0,0,0,4,4,5,89,73,0,0,74,0,2,2,1,0,3,2,133,0,0,0,4,3,0,0,1,0,0,3,292,2,2,0
0,6,22,10,2,8,0,838,11,0,0,1,182,1,8,0,4,8,256,2,2,2,10,15,16,9,16,0,1,12,3,4,10,16,14,464,322,16,599,19,196,8,4,1,0,2,2,4,16,124,23,5,4,4,4,5,0,0,11,2,299,11,10,20,12,107,16,10,8,4,0,3,8,13,10,0,8,23,0,12,2,2,5,201,16,9,2,7,8,5,0,14,108,19,0,3
2,15,2,17,16,0,8,3,14,4,4,8,5,2,36,4,16,21,16,2,10,2,0,10,29,33,10,204,0,4,18,8,12,96,16,8,0,16,6,4,8,9,0,8,0,20,7,12,23,16,23,4,12,23,0,396,3,15,15,6,13,0,4,2,0,2,992,366,18,12,12,11,10,20,7,19,50,28,9,12,62,12,8,15,6,10,11,4,6,9,15,11,8,32,3,11
2,1,17,15,0,16,2,4,15,10,0,8,17,8,12,1163,14,0,8,8,1,6,254,0,19,0,0,8,1,302,23,5,0,11,143,15,0,3,10,0,8,0,2,8,9,0,2,2,7,8,0,7,0,3,755,2,1,4,12,4,163,7,6,13,0,494,0,55,13,1,12,4,2,6,7,8,2,22,2,4,179,217,10,14,21,4,5,0,2,19,15,293,4,8,6,12
2,4,20,0,15,17,10,2,3,6,0,7,4,12,3,2,9,2,3,4,2,4,1,14,3,9,10,5,7,31,4,24,0,15,18,12,17,2,11,2,7,2,0,1,1,8,24,4,6,2,2,7,4,145,23,0,88,0,4,0,6,0,6,2,0,6,6,18,2,10,0,0,2,4,8,15,8,10,4,4,52,8,0,10,2,12,4,13,4,4,3,10,0,2,2,2
6,2,0,20,17,2,22,10,0,1057,4,4,15,1,9,5,47,4,0,3,3,2,4,10,7,10,3,7,0,14,5,2,7,9,16,17,2,8,13,28,34,7,2,10,1,6,10,0,13,11,4,6,4,93,10,7,140,2,13,6,9,6,10,16,4,26,34,4,5,19,0,7,12,9,17,4,6,11,10,8,8,4,21,854,5,16,0,9,7,16,15,5,17,26,1,12
14,0,2,4,1,15,6,0,16,4,4,1,2,12,10,0,0,0,91,4,8,4,0,34,6,0,5,1,7,18,2,1,14,8,18,4,0,24,261,8,10,4,8,2,3,16,5,10,11,6,6,6,6,1,0,0,1,0,8,2,9,0,0,10,6,10,0,37,17,10,4,10,0,186,45,16,2,2,8,6,2,3,13,3,27,7,10,8,0,8,31,28,2,4,22,5
0,14,6,2,2,2,0,0,2,0,0,0,6,4,5,0,2,6,4,0,0,0,186,4,0,0,0,5,8,4,9,10,0,5,5,4,8,3,0,0,4,13,0,0,17,3,5,0,19,4,10,444,12,4,6,4,18,1,4,1330,0,4,4,4,0,151,2,2,15,8,0,0,10,6,8,1,508,7,3,2,0,1,4,1,12,4,2,0,2,0,4,10,0,4,7,5
