4,202,9,14,2,10,16,0,3,6,2,8,8,54,9,184,12,0,22,12,2,0,0,0,9,32,0,6,11,0,8,0,1,4,9,79,10,3,10,10,4,5,0,6,1,37,30,25,3,10,4,0,0,14,4,132,4,8,9,4,2,8,4,658,20,0,672,7,0,4,135,10,8,9,18,2,8,8,225,1,0,163,24,0,12,0,0,0,5,6,13,14,17,7,241,0
2,4,4,10,3,12,42,638,4,8,2,10,15,0,24,22,2,2,17,8,11,0,0,16,9,9,8,15,5,2,192,4,1,1676,5,2,4,4,0,20,6,0,18,10,10,0,2,17,3,6,8,6,12,12,0,2,22,16,8,2,8,14,13,1,1083,5,29,0,18,4,4,8,18,34,26,10,9,4,0,4,3,4,11,2,10,2,0,228,6,8,13,8,5,8,0,241
7,2,13,2,5,16,14,63,4,12,4,0,3,9,11,1,15,24,8,4,19,0,2,13,4,18,0,8,6,8,11,23,0,4,3,5,20,2,11,11,8,11,17,50,3,691,184,10,7,2,7,0,6,540,8,0,20,8,6,21,0,60,0,3,6,9,15,0,1,8,2,19,6,6,26,24,5,15,16,13,4,537,12,5,0,285,0,26,20,9,18,21,9,0,8,7
0,164,10,8,2,6,1,0,212,6,6,33,2,0,1,4,8,12,13,4,1,0,6,12,6,8,0,310,0,0,16,1,8,3,0,3,0,4,416,1112,0,2,17,8,1,13,30,4,0,0,14,6,20,0,0,8,36,0,5,9,24,0,6,5,0,0,12,6,0,38,10,11,11,4,4,0,0,6,1,9,2,2,15,0,0,29,14,8,0,0,8,6,0,9,5,17
0,0,3,12,0,1,6,0,8,0,12,4,8,2,1,0,10,199,2,5,8,0,0,8,0,2,0,0,9,5,4,0,0,2,2,0,166,0,4,4,1,3,4,8,2,4,9,8,0,12,4,4,6,2,2,10,288,2,0,8,1495,8,5,1,0,1,4,5,0,2,16,21,4,0,18,16,6,0,8,16,4,15,10,0,6,0,12,168,2,0,3,0,6,21,8,14
8,0,14,3,0,2,2,84,0,4,2,8,3,2,3,2,17,6,28,4,5,0,86,8,15,4,12,4,253,6,6,8,2,16,19,2,5,2,0,3,232,0,16,4,9,0,10,20,0,10,8,0,230,10,18,4,2,1,8,28,13,5,5,10,21,0,4,14,16,9,16,8,10,23,8,4,6,4,0,4,183,0,12,6,0,0,1,203,10,2,0,3,8,18,13,13
2,12,0,9,18,2,10,0,4,8,4,4,4,0,190,57,2,2,24,8,0,0,0,315,18,6,8,4,5,14,0,6,0,6,9,6,132,6,14,4,297,0,23,28,0,16,9,18,7,4,8,8,2,11,10,4,8,0,8,3,24,4,9,7,0,1,8,0,12,4,21,22,3,0,3,144,30,0,0,4,2,26,12,2,2,0,2,46,8,0,2,0,0,9,8,6
0,2,10,8,84,4,2,0,157,4,10,0,4,4,4,8,24,17,3,6,26,3,0,43,6,35,6,8,24,11,34,2,0,12,2,6,5,0,17,10,3,4,6,10,2,34,12,18,1,6,22,0,2,0,7,11,0,0,8,4,0,7,0,1,4,30,0,2,0,0,2,7,28,12,12,6,5,8,6,4,2,1249,784,12,4,4,0,14,0,8,10,2,0,20,6,5
5,0,11,3,549,12,0,0,2,8,58,1,4,8,4,0,0,0,932,159,8,0,0,8,0,8,0,0,11,2,4,0,0,5,4,0,106,2,0,14,5,2,5,15,0,10,8,4,0,8,2,6,0,10,8,5,4,12,0,11,10,0,530,138,0,0,26,0,12,8,15,2,18,6,14,10,4,4,6,1,10,0,8,0,2,0,792,0,14,46,203,168,8,26,228,0
0,0,4,7,3,0,0,2,28,25,4,2,2,0,0,0,4,0,15,70,0,0,0,0,0,2,0,8,0,2,0,1,13,1,5,0,0,0,0,11,0,2,0,0,0,8,0,0,0,0,0,26,4,3,2,1,1,2,0,2,3,4,7,3,1,28,11,262,0,0,2,0,0,0,0,0,3,3,2,5,0,0,4,2,0,0,0,792,0,2,1,12,14,0,0,0
0,58,0,1,6,0,0,0,4,26,0,2110,0,0,3,3,2,4,0,1,1,0,8,4,2,14,0,1,5,0,0,5,2,0,8,8,2,0,106,4,10,16,2,0,0,8,29,8,2,0,3,0,0,4,0,16,0,4,3,4,5,0,0,0,16,0,0,2,0,27,0,113,0,2,11,2,0,3,1,1,0,2,2,2,0,0,0,0,4,0,0,0,29,285,2,0
0,0,12,0,0,2,0,0,0,2,0,0,4,34,0,0,0,0,2,0,2,0,0,108,0,0,6,0,18,0,3,0,4,0,6,0,4,0,0,4,3,31,0,4,0,0,0,0,0,0,2,2,0,2,238,971,0,0,4,342,11,2,0,1,3,34,3,0,1374,0,6,2,167,1,2,5,0,0,4,0,0,8,295,0,0,0,0,2,4,2,0,6,0,0,10,12
5,4,942,2,9,0,2,0,0,0,40,4,2,116,3,1,6,0,1,8,10,0,80,9,42,97,2,0,12,0,0,0,295,6,7,29,0,0,3,6,2,9,2,0,8,12,4,2,0,2,2,18,0,0,5,2,2,0,14,30,0,2,4,0,8,2,32,0,0,22,5,8,13,6,264,16,2,5,2,33,47,5,7,0,0,2,2,0,12,2,6,0,0,5,2,0
0,0,18,12,12,10,12,7,0,9,0,14,3,1011,5,19,16,0,73,12,8,0,4,19,7,21,14,14,26,10,16,10,7,2,70,45,6,8,22,4,26,0,9,8,2,18,6,14,3,4,14,4,12,10,22,7,5,5,10,2,18,23,9,9,19,27,14,9,10,11,14,10,460,12,14,24,36,4,17,572,9,10,0,7,295,2,4,8,784,12,12,10,15,12,11,24
1,6,55,0,10,0,4,0,4,3,6,0,0,2,4,34,526,0,18,12,0,0,0,12,5,25,8,6,4,4,0,2,0,0,13,0,4,0,38,4,0,0,0,10,8,0,1,6,2,9,13,1,8,7,8,4,7,10,0,13,8,5,0,8,237,11,0,389,0,0,22,12,33,8,39,4,5,10,2,0,1,0,10,5,8,2,0,0,1249,26,0,15,2,537,4,163
0,0,14,2,2,382,0,3,0,18,20,0,51,0,5,4,4,271,1203,14,14,2,47,5,49,74,2,11,0,4,1,100,34,1,4,0,0,36,4,44,2,0,0,4,74,4,4,6,0,0,156,13,507,175,5,3,14,2,0,4,4,2,66,7,2,2,2,2,579,6,7,2,2,13,6,0,0,2,2,4,0,1,9,47,0,0,0,10,2,2,183,4,2,4,3,0
84,1,8,4,878,4,30,2,9,6,4,10,36,1,48,12,206,0,11,4,2,0,6,8,0,2,0,64,14,10,22,0,0,4,4,0,2,2,16,17,8,1,6,16,9,87,0,3,0,5,54,0,1006,4,2,0,0,0,713,41,0,0,0,12,74,0,347,6,4,102,4,4,6,9,2,0,0,0,5,0,4,0,572,33,0,1,5,1,4,4,4,16,9,13,4,1
103,43,10,2,1,0,8,13,254,6,8,0,6,16,0,2,14,0,8,35,0,2,0,262,4,4,4,14,2,2,0,4,0,2,6,8,28,2,32,6,0,12,6,12,54,423,6,26,42,2,16,2,3,3,3,8,2,0,14,4,0,8,0,13,11,6,31,33,10,0,8,6,4,11,14,6,147,0,0,5,2,2,17,2,4,1,2,6,6,0,0,8,1,16,0,225
1270,31,10,4,88,3,2,10,11,6,2,30,5,3,1,10,15,0,4,9,3,0,0,5,3,8,4,1,2,12,1,4,8,4,11,5,8,0,3,8,8,0,13,17,5,14,25,2,32,4,6,10,12,2,8,0,2,0,13,3,5,10,4,10,0,2,10,0,2,11,649,1,3,4,2,8,0,0,0,0,2,10,4,5,0,3,3,4,8,0,4,0,6,15,4,8
0,8,5,8,13,3,2,0,0,8,6,4,0,3,0,5,8,0,8,6,4,0,0,4,0,4,0,0,8,2,12,10,6,278,9,0,64,0,8,2,13,188,4,0,0,5,4,0,4,24,9,0,0,12,8,4,0,10,15,11,4,4,0,0,4,0,13,10,8,8,36,4,5,4,0,0,0,0,147,0,0,5,36,2,0,0,3,4,5,30,6,6,0,5,9,8
5,2,14,2,5,1,1,2,5,8,54,11,0,3,142,2,4,12,14,0,44,12,9,4,5,0,6,14,541,12,145,1,0,2,19,174,5,4,607,14,293,2,42,7,1,721,15,0,0,16,8,2,4,708,8,0,0,4,0,6,6,0,10,165,8,24,4,4,4,10,800,1,18,23,12,0,0,8,6,0,0,4,24,16,5,2,0,10,6,144,4,16,0,24,10,2
3,6,200,12,12,12,34,2,8,228,7,16,20,14,8,6,24,5,24,13,6,0,99,1,6,2,0,3,2,11,8,9,2,2,9,0,12,0,12,2,8,5,4,10,5,3,2,10,2,2,25,24,20,8,2,8,26,10,12,14,6,0,14,2,14,2,426,19,0,4,20,9,50,8,0,12,0,2,14,2,6,39,14,264,2,11,0,14,12,3,8,18,4,26,26,18
0,1,779,21,7,12,3,2,0,4,6,4,8,4,8,1,2,4,8,6,0,32,13,4,10,14,0,14,16,25,4,0,8,6,4,2,0,7,9,27,0,0,8,11,12,234,9,21,2,0,2,2,3,19,2,0,8,2,12,12,2,2,10,2,57,4,20,0,14,12,11,8,43,0,8,23,4,4,11,9,13,8,12,6,1,2,0,6,12,0,23,0,4,6,34,9
2,6,16,16,9,14,18,2,1,18,8,10,10,1046,6,18,110,8,1068,2,6,16,0,12,2,50,0,8,8,0,2,4,9,2,12,6,4,26,12,8,0,4,12,8,0,10,4,20,7,7,23,8,4,24,5,8,6,5,6,10,8,0,4,1,368,6,8,20,9,12,14,8,0,43,50,18,5,3,4,6,2,33,460,13,167,0,0,18,28,3,10,4,11,6,18,8
0,9,6,10,21,12,10,0,12,10,6,6,6,0,0,236,7,2,652,6,0,5,1,8,13,2,8,7,3,8,1,3,9,10,4,8,11,5,6,0,64,0,12,15,16,4,2,16,10,4,8,11,20,6,0,7,23,0,3,0,0,8,0,2,0,2,4,9,0,24,6,0,8,8,9,1,4,1,6,4,2,12,10,8,2,113,0,2,7,22,8,21,11,19,8,10
3,5,20,12,41,12,3,206,71,7,6,8,0,2,14,5,12,12,5,13,5,9,0,460,9,12,1,2,14,8,5,10,6,11,4,9,1,1,160,8,0,0,6,15,0,7,19,9,2,14,13,2,4,8,2,5,4,1,2,25,11,8,3,2,10,2,10,9,20,12,0,6,14,11,20,800,36,649,8,4,7,22,14,5,6,0,2,15,2,21,16,16,10,2,4,135
0,610,592,2,2,4,8,0,29,30,6,0,0,164,0,5,0,0,276,9,11,1,0,7,1,3,0,4,0,0,0,0,12,8,0,322,0,0,3,9,5,2,8,3,0,10,13,2,0,0,10,1577,4,4,21,0,0,0,2,2,28,7,0,455,636,0,6,0,6,0,12,24,12,12,4,10,8,11,0,102,6,0,11,22,0,27,0,8,0,4,9,2,38,8,4,4
0,0,2,0,15,8,8,2,0,2,2,0,28,8,0,14,8,0,9,4,12,0,0,7,0,0,0,4,10,22,0,14,581,7,16,0,0,6,4,0,0,0,6,0,2,7,0,0,0,0,10,0,4,3,1,0,1,0,16,1,9,4,3,8,1,0,933,0,0,6,20,0,9,14,0,4,8,2,10,4,579,0,10,0,1374,0,0,12,0,12,16,0,0,1,18,0
4,45,17,3,8,1,18,2,8,0,4,13,0,1,0,0,3,9,0,14,1,4,16,12,2,12,0,152,9,7,4,4,3,6,8,0,41,2,14,10,11,0,2,2,12,13,8,10,17,8,48,4,6,10,4,8,2,4,6,6,0,16,2,8,22,0,10,0,0,0,9,9,20,0,19,4,10,0,33,6,2,389,9,0,0,2,262,0,2,0,14,5,6,0,0,7
31,3,12,0,190,16,7,4,0,2,332,4,12,2,42,35,4,6,12,2,2,6,2,13,2,2,0,3,31,12,4,2,13,0,38,477,5,9,18,27,0,6,0,18,8,56,6,3,3,0,588,0,0,7,4,7,4,14,2,10,114,78,27,750,4,0,0,10,933,6,10,4,8,20,426,4,13,10,31,347,2,0,14,32,3,0,11,26,0,8,4,4,12,15,29,672
0,0,11,509,780,2,3,0,20,14,0,4,0,46,8,0,0,0,3,0,0,8,0,0,1,147,0,8,2,10,8,0,10,0,18,0,0,606,4,20,2,0,0,1,8,263,1,8,0,0,7,33,0,1747,0,18,0,8,2,2,7,3,4,0,3,0,0,0,0,0,2,2,6,4,2,24,0,2,6,0,2,11,27,2,34,0,28,0,30,1,0,1,0,9,5,0
423,201,3,1,297,6,25,0,3,3,2,4,16,2,8,2,8,12,0,28,0,0,10,16,9,4,1,14,9,8,6,124,7,0,30,0,12,6,14,8,2,4,4,8,0,16,0,15,6,14,3,3,2,8,12,11,4,0,21,0,0,1,2,0,0,3,4,22,1,636,10,0,368,57,14,8,4,0,11,74,2,237,19,8,3,16,1,0,4,0,21,0,0,6,1083,20
8,4,4,2,12,4,6,44,2,0,14,16,6,20,16,4,306,11,0,2,47,15,11,62,4,4,7,0,0,12,0,0,8,8,2,0,8,1,13,6,0,26,2,4,3,66,11,0,0,0,12,61,2,3,2,8,1,85,2,59,230,18,0,0,0,0,750,8,8,455,2,2,1,2,2,165,0,10,13,12,7,8,9,0,1,0,3,138,1,7,10,1,5,3,1,658
8,0,0,41,23,4,0,4,0,15,8,0,8,249,4,0,0,0,206,6,0,0,0,2,34,10,0,3,2,1,2,0,24,4681,4,71,136,18,4,8,0,0,5,0,146,6,587,2,0,0,610,4,2,0,0,0,6,2,1,0,6,2,0,0,2,4,27,2,3,0,3,0,4,10,14,10,0,4,0,0,66,0,9,4,0,0,7,530,0,9,5,5,6,0,13,4
0,5,16,12,2,2,238,10,1,0,2,0,8,7,18,0,13,0,13,12,0,0,2,9,0,2,411,9,10,22,8,10,4,4,702,939,0,1,9,12,4,10,1,9,3,2,2,26,10,8,12,5,16,10,5,327,9,16,4,7,5,0,2,18,1,3,78,16,4,7,8,8,0,2,0,0,4,10,8,0,2,5,23,2,2,0,4,0,7,4,5,8,0,60,14,8
0,4,16,439,15,17,13,0,2,12,4,13,2,1,4,8,5,391,225,2,0,5,0,6,1,26,11,0,0,1,15,0,8,4,11,3,4,12,4,2,4,11,3,8,4,2,4,4,4,2,6,1,0,226,12,5,2,1,622,2,0,5,6,230,0,7,114,0,9,28,11,0,8,2,6,6,4,5,0,0,4,8,18,0,11,5,3,10,0,24,13,1495,24,0,8,2
0,4,9,3,4,6,386,0,4,18,5,429,0,2,8,1,15,3,4,550,4,0,2,14,5,9,0,16,0,0,6,5,5,0,220,2,224,9,10,6,14,1,0,7,105,2,8,19,36,19,24,0,1,16,19,8,0,18,4,0,2,7,0,59,0,2,10,6,1,2,25,0,10,12,14,6,11,3,4,41,4,13,2,30,342,4,2,11,4,3,28,8,9,21,2,4
2,18,6,1,2,4,8,4,0,1,1,2,1,7,521,2,8,2,37,1,0,0,0,0,40,11,4,4,20,8,1,8,3,3,160,0,10,2,400,8,427,5,1,4,2,9,2,22,2,8,12,10,0,8,14,10,0,2,0,4,622,4,1,2,21,2,2,6,16,2,2,3,6,12,12,0,15,13,14,713,0,0,10,14,4,3,0,0,8,8,8,0,5,6,8,9
2,8,16,4,24,16,20,0,6,0,0,4,109,1,3,18,18,6,12,4,1,0,2,14,7,2,647,0,10,0,13,15,0,45,10,2,7,8,2,4,4,0,8,2,0,211,17,6,10,2,0,3,0,29,18,0,8,0,2,18,1,16,2,85,0,8,14,4,0,0,1,0,5,2,10,4,10,0,0,0,2,10,5,0,0,4,2,12,0,0,1,2,0,8,16,8
26,3,0,4,4,8,5,1548,2,265,6,0,60,6,13,8,6,79,16,130,2,0,0,10,2,10,1,16,16,2,13,0,0,8,389,0,4,7,8,11,14,6,0,8,231,6,0,20,8,0,24,0,50,9,4,8,0,8,0,0,2,9,6,1,4,0,4,2,1,0,4,23,6,8,26,0,0,2,2,0,14,7,5,2,0,0,1,4,0,8,2,288,36,20,22,4
0,12,2,25,1,1,2,37,10,3,0,0,708,65,4,2,0,4,0,4,0,0,5,62,4,8,10,2,6,0,8,8,6,0,8,987,8,2,4,3,0,188,0,521,8,6,0,84,4,4,4,61,0,8,215,0,8,0,10,8,5,327,0,8,11,18,7,8,0,0,5,7,8,0,8,0,4,0,8,0,3,4,7,2,971,16,1,5,11,4,4,10,8,0,2,132
2,0,36,2,2,0,6,9,4,2,6,2,8,17,20,8,12,10,9,9,1,0,0,8,0,3,0,6,480,10,8,3,12,3,63,11,5,2,28,8,19,4,2,2,261,7,6,3,3,12,2,14,5,18,0,215,4,18,14,19,12,5,0,2,12,0,4,4,1,21,2,0,5,2,2,8,8,8,3,2,5,8,22,5,238,0,2,8,7,10,18,2,0,8,0,4
34,13,26,744,371,19,3,2,0,0,8,0,128,4,37,35,2,9,10,8,0,9,2,2,10,1,0,5,5,1,21,557,4,1,18,0,16,24,10,2,10,0,165,8,0,12,2,4,0,2,2,1,109,0,18,8,9,29,8,16,226,10,0,3,8,1747,7,10,3,4,8,6,24,19,8,708,12,2,3,4,175,7,10,0,2,4,3,10,0,11,10,2,0,540,12,14
2,10,4,4,10,2,0,8,2,294,8,0,283,0,17,0,56,104,19,2,0,2,90,5,0,0,0,60,2,21,12,11,0,1,1,0,0,4,0,8,4,0,1,4,1,7,0,1,0,0,35,10,0,109,5,0,50,0,0,1,0,16,2,2,2,0,0,6,4,4,4,20,4,3,20,4,0,12,3,1006,507,8,12,0,0,0,4,0,2,2,230,6,20,6,12,0
1,0,15,2,2,4,6,0,31,6,7,2,9,28,1,0,10,0,12,11,10,0,0,4,2,4,15,0,0,0,2,0,6,4,4,0,6,0,0,7,14,4,2,0,0,8,3,0,0,0,8,0,10,1,14,61,0,3,10,0,1,5,4,61,3,33,0,4,0,1577,2,11,8,2,24,2,0,10,2,0,13,1,4,18,2,0,26,6,0,8,0,4,6,0,6,0
0,34,2,2,39,0,0,38,0,18,2,0,12,0,1,4,73,0,96,9,0,0,0,24,7,8,0,21,4,7,4,20,9,0,14,21,209,18,2,11,8,2,4,14,10,22,5,2,15,10,0,8,35,2,2,4,24,0,12,24,6,12,610,12,3,7,588,48,10,10,13,8,23,2,25,8,9,6,16,54,156,13,14,2,2,3,0,2,22,8,8,4,14,7,8,4
1,9,5,2,12,0,0,1,0,2,13,0,0,3,3,2,2,0,6,20,0,0,88,16,0,2,8,12,8,0,64,364,8,18,4,0,0,4,15,2,22,0,8,21,4,1,7,2,2,0,10,0,0,2,12,4,0,2,8,19,2,8,0,0,14,0,0,8,0,0,14,4,7,0,2,16,24,4,2,5,0,9,4,2,0,0,0,8,6,4,10,12,0,2,6,10
0,80,0,4,12,0,236,0,21,22,5,46,0,9,0,150,0,171,6,0,201,0,2,0,12,4,0,10,0,2,0,0,0,0,5,8,0,0,2,3,0,15,11,0,10,4,0,10,0,2,15,0,0,0,3,4,8,10,2,36,4,10,0,0,6,0,3,17,0,0,2,10,7,2,2,0,4,32,42,0,0,2,3,0,0,2,0,0,1,7,0,0,0,7,3,3
0,134,16,10,2,4,44,1,8,12,1,12,2,19,21,2,4,2,12,0,0,0,1,5,160,18,9,43,14,3,4,2,2,8,14,340,16,10,2,8,4,6,4,12,4,0,8,0,10,2,2,0,1,4,3,84,20,6,22,19,4,26,2,0,15,8,3,10,0,2,9,16,20,21,10,0,0,2,26,3,6,6,14,2,0,8,0,4,18,18,20,8,4,10,17,25
2,0,60,14,7,13,12,37,11,2,8,32,4,7,230,8,18,4,6,200,4,4,7,10,0,22,0,8,6,0,2,6,8,2,4,6,4,0,11,25,8,0,12,11,1,128,0,8,0,7,5,3,0,2,6,0,0,17,2,8,4,2,587,11,0,1,6,8,0,13,19,2,4,9,2,15,4,25,6,0,4,1,6,4,0,29,0,8,12,9,10,9,30,184,2,30
2,16,29,1,7,0,2,5,3,0,4,0,4,102,4,0,10,0,18,18,2,2,1,5,0,24,6,8,6,5,0,4,4,4,10,1,18,4,95,8,2,4,54,17,13,0,128,0,4,1,22,8,7,12,7,6,6,211,9,2,2,2,6,66,16,263,56,13,7,10,7,4,10,234,3,721,5,14,423,87,4,0,18,12,0,8,8,10,34,16,0,4,13,691,0,37
46,4,2,4,5,0,11,262,10,3,10,1,10,0,12,0,10,15,0,61,1,0,6,0,0,164,4,8,0,4,4,2,0,0,4,10,1,2,2,4,0,2,960,4,0,13,1,4,10,4,10,0,1,0,261,8,231,0,2,105,4,3,146,3,0,8,8,12,2,0,0,16,0,12,5,1,0,5,54,9,74,8,2,8,0,0,0,0,2,0,9,2,1,3,10,1
0,4,6,0,15,11,4,0,81,57,2,0,244,18,12,9,174,1,13,17,0,0,2,15,0,4,1,9,6,8,4,4,0,0,7,599,15,156,21,5,11,4,6,0,4,17,11,12,0,21,14,0,4,8,2,521,8,2,4,7,8,9,0,4,8,1,18,2,0,3,15,15,8,11,10,7,0,17,12,16,4,10,8,0,4,0,0,15,10,28,4,8,8,50,10,6
2,6,24,2,12,14,2,0,0,8,2,27,2,0,17,10,15,4,38,0,0,0,0,0,0,0,0,1072,4,364,4,0,0,0,14,5,6,8,0,8,675,4,0,6,960,54,12,4,11,8,4,2,1,165,2,0,0,8,1,0,3,1,5,2,4,0,0,2,6,8,6,12,12,8,4,42,4,13,6,6,0,0,9,2,0,2,0,5,6,23,16,4,17,17,18,0
1,6,6,414,318,0,0,54,30,4,944,0,12,204,2,0,6,0,1,8,42,0,2,185,9,0,20,2,6,3,0,0,0,2,8,26,0,0,4,6,2,0,4,4,2,4,0,6,15,0,2,4,0,0,4,188,6,0,5,1,11,10,0,26,4,0,6,0,0,2,0,0,4,0,5,2,188,0,12,1,0,0,0,9,31,16,2,2,4,0,0,3,2,11,0,5
0,6,12,8,12,10,0,0,0,3,3,4,18,3,8,0,8,0,15,40,2,0,6,176,81,37,0,527,242,0,278,21,2,2,7,0,2,2,32,11,0,2,675,11,0,2,8,4,0,22,8,14,4,10,19,0,14,4,427,14,4,4,0,0,2,2,0,11,0,5,0,64,0,0,8,293,13,8,0,8,2,0,26,2,3,10,0,5,3,297,232,1,0,8,6,4
0,0,6,17,9,464,0,5,4,2,10,12,12,2,18,2,18,0,4,12,0,0,1135,5,4,18,0,536,48,21,4,2,100,2,17,4,10,0,22,0,11,6,8,5,4,8,25,8,3,2,11,7,8,2,8,3,11,4,8,6,2,12,8,6,8,20,27,10,0,9,8,0,8,27,2,14,2,8,6,17,44,4,4,6,4,4,11,14,10,4,3,4,1112,11,20,10
0,87,30,10,7,13,11,0,597,6,2,16,10,2,74,4,12,2,4,26,0,6,1,14,0,61,6,9,7,4,16,2,7,11,17,2,24,0,0,22,32,4,0,21,2,95,11,2,2,15,2,0,0,10,28,4,8,2,400,10,4,9,4,13,14,4,18,14,4,3,160,6,12,9,12,607,8,3,32,16,4,38,22,3,0,106,0,0,17,14,0,4,416,11,0,10
0,1,2,0,6,9,6,4,0,3,2,0,4,4,9,2,0,1,19,0,2,10,0,4,0,9,9,10,12,9,34,2,0,9,8,0,5,0,0,0,2,0,8,156,2,4,0,10,0,4,18,0,4,24,2,2,7,8,2,9,12,1,18,1,6,606,9,2,6,0,1,5,26,7,0,4,0,0,2,2,36,0,8,0,0,0,0,2,0,6,2,0,4,2,4,3
0,8,12,2,2,15,8,2,12,10,4,8,4,1,0,8,0,0,2,6,0,2,12,69,5,3,0,1,2,0,2,0,7,6,10,3,0,5,24,10,2,0,6,15,1,18,4,16,0,0,209,6,0,16,5,8,4,7,10,224,4,0,136,8,12,0,5,41,0,0,1,11,4,0,12,5,64,8,28,2,0,4,6,0,4,2,0,106,5,132,5,166,0,20,4,10
9,177,372,0,6,0,622,1,0,214,23,0,6,26,0,0,1,0,5,1,0,0,2,0,32,0,0,2,0,0,0,4,0,0,4,0,3,0,2,4,0,26,5,599,10,1,6,340,8,0,21,0,0,0,11,987,0,2,0,2,3,939,71,0,0,0,477,0,0,322,9,8,6,2,0,174,0,5,8,0,0,0,45,29,0,8,0,0,6,6,2,0,3,5,2,79
2,8,7,12,4,17,23,2,36,5,6,1,415,3,7,17,3,6,4,14,8,2,4,2442,0,3,9,10,9,0,8,10,4,5,0,4,10,8,17,17,7,8,14,7,4,10,4,14,5,4,14,4,1,18,63,8,389,10,160,220,11,702,4,2,30,18,38,8,16,0,4,4,12,4,9,19,9,11,6,4,4,13,70,7,6,8,5,4,2,9,19,2,0,3,5,9
0,0,20,2,8,4,1,1,0,2,7,2,0,0,6,8,8,4,16,2,0,1,0,0,0,4,0,4,0,3,19,4,8,0,5,0,6,9,11,2,2,2,0,0,0,4,2,8,0,18,0,4,1,1,3,0,8,45,3,0,4,4,4681,8,0,0,0,6,7,8,11,10,2,6,2,2,278,4,2,4,1,0,2,6,0,0,1,5,12,6,16,2,3,4,1676,4
117,128,2,11,7,186,8,124,16,12,1,3,2,3,14,43,4,4,0,1231,0,253,44,5,24,8,0,0,14,8,2,3,0,8,4,0,7,0,7,100,2,0,0,0,0,4,8,2,0,8,9,6,0,4,12,6,0,0,3,5,8,4,24,8,7,10,13,3,581,12,6,9,9,8,2,0,6,8,0,0,34,0,7,295,4,2,14,0,0,0,2,0,8,0,1,1
0,104,4,4,4,8,0,0,2,7,2,0,0,10,4,5,268,5,10,397,5,0,0,1,6,3,0,15,13,29,20,0,3,4,10,4,0,2,2,2,21,0,0,4,2,4,6,2,0,364,20,0,11,557,3,8,0,15,8,5,0,10,0,0,124,0,2,4,14,0,10,3,4,0,9,1,10,4,4,0,100,2,10,0,0,5,1,0,2,6,8,0,1,23,4,0
0,15,13,15,881,12,6,8,83,8,10,4,426,10,0,6,10,5,3,0,0,0,4,8,2,5,0,2,26,14,0,20,2,19,8,0,2,34,16,4,278,0,4,4,4,0,2,4,0,64,4,2,12,21,8,8,13,13,1,6,15,8,2,0,6,8,4,4,0,0,5,1,2,4,8,145,12,1,0,22,1,0,16,0,3,0,0,4,34,0,6,4,16,11,192,8
2,2,9,12,8,9,8,0,4,0,4,0,4,0,1,0,6,612,12,12,0,0,2,2,0,0,8,8,14,0,14,29,8,3,0,0,0,9,4,21,0,3,364,8,4,5,0,3,2,0,7,0,21,1,10,0,2,0,8,0,1,22,1,12,8,10,12,7,22,0,8,8,0,25,11,12,2,12,2,10,4,4,10,0,0,0,2,2,11,14,6,5,0,8,2,0
2,0,6,7,138,192,1,0,5,4,2,12,12,8,27,44,0,0,10,4,2,0,0,16,110,793,6,8,0,14,26,13,14,0,9,0,2,12,7,48,242,6,4,6,0,6,6,14,0,8,4,0,2,5,480,6,16,10,20,0,0,10,2,0,9,2,31,9,10,0,14,3,8,16,2,541,8,2,2,14,0,4,26,12,18,5,0,11,24,5,253,9,0,6,5,11
0,14,5,2,10,5,36,4,0,2,8,5,131,3,22,5,0,0,8,11,4,3,0,0,0,31,1,0,8,8,2,15,0,4,10,2,1,10,9,536,527,2,1072,9,8,8,8,43,10,12,21,0,60,5,6,2,16,0,4,16,0,9,3,0,14,8,3,152,4,4,2,7,8,14,3,14,0,1,14,64,11,6,14,0,0,1,8,0,8,4,4,0,310,8,15,6
0,2,0,23,3,4,1,19,1,0,18,3,5,1,0,0,0,1,0,1,4,0,12,5,0,4,0,1,6,8,0,0,0,0,9,0,0,9,6,0,0,20,0,1,4,6,0,9,0,8,0,15,0,0,0,10,1,647,4,0,11,411,0,7,1,0,0,0,0,0,1,8,0,0,0,6,0,4,4,0,2,8,14,2,6,0,0,0,6,8,12,0,0,0,8,0
2,6,5,18,17,4,14,0,2,1,4,5,14,8,61,0,10,0,6,12,3,2,2,5,710,0,4,31,793,0,5,3,8,4,3,0,3,9,61,18,37,0,0,4,164,24,22,18,4,2,8,4,0,1,3,8,10,2,11,9,26,2,10,4,4,147,2,12,0,3,12,2,50,14,2,0,4,8,4,2,74,25,21,97,0,14,2,8,35,6,4,2,8,18,9,32
4,2,1,7,0,6,0,2,86,2,20,2,2,0,0,0,2,8,2,3,0,0,0,0,0,710,0,0,110,0,2,6,24,0,0,32,5,0,0,4,81,9,0,0,0,0,0,160,12,0,7,2,0,10,0,4,2,7,40,5,1,0,34,4,9,1,2,2,0,1,9,13,2,10,6,5,0,3,4,0,49,5,7,42,0,2,0,0,6,18,15,0,6,4,9,9
0,9,11,2,0,0,4,0,5,2,38,0,103,0,25,0,174,311,18,19,17,0,4,0,0,5,5,0,16,2,8,1,5,0,2442,0,69,4,14,5,176,185,0,15,0,5,10,5,0,16,24,4,5,2,8,62,10,14,0,14,6,9,2,62,16,0,13,12,7,7,460,8,12,4,1,4,4,5,262,8,5,12,19,9,108,4,0,8,43,315,8,8,12,13,16,0
0,0,8,2,1,190,0,13,184,2,2,163,3,0,2,0,110,13,2,4,58,2,0,4,0,2,12,0,0,2,4,0,44,0,4,2,12,0,1,1135,6,2,0,2,6,1,7,1,2,88,0,0,90,2,0,5,0,2,0,2,0,2,0,11,10,0,2,16,0,0,0,1,0,13,99,9,0,0,0,6,47,0,4,80,0,8,0,0,0,0,86,0,6,2,0,0
0,0,4,0,135,0,0,0,0,2,11,0,0,0,0,2,0,0,0,0,14,0,2,0,0,2,0,3,0,0,0,0,253,1,2,0,2,10,6,0,0,0,0,0,0,2,4,0,0,0,0,0,2,9,0,0,0,0,0,0,5,0,0,15,0,8,6,4,0,1,9,5,16,32,0,12,0,0,2,0,2,0,0,0,0,0,0,0,3,0,0,0,0,0,0,0
0,0,8,12,0,0,16,61,9,2,66,0,4,8,0,0,1,1143,9,2,0,14,58,17,0,3,4,4,2,0,0,5,0,0,8,0,0,2,0,0,2,42,0,0,1,2,4,0,201,0,0,10,0,0,1,0,2,1,0,4,0,0,0,47,0,0,2,1,12,11,5,0,6,0,6,44,4,3,0,2,14,0,8,10,2,1,0,8,26,0,5,8,1,19,11,2
3,0,12,5,8,0,56,542,3,8,107,12,10,8,4,0,0,0,27,0,2,0,4,19,3,12,1,11,4,12,0,397,1231,2,14,1,6,0,26,12,40,8,0,17,61,18,200,0,0,20,9,11,2,8,9,4,130,4,1,550,2,12,6,2,28,0,2,14,4,9,13,6,2,6,13,0,6,9,35,4,14,12,12,8,0,1,70,159,6,8,4,5,4,4,8,12
5,8,13,9,8,4,6,4,0,4,7,8,4,841,5,5,8,3,0,27,9,0,2,18,2,6,0,8,10,12,3,10,0,16,4,5,2,19,4,4,15,1,38,13,0,18,6,12,6,6,96,12,19,10,9,0,16,12,37,4,225,13,206,0,0,3,12,0,9,276,5,652,1068,8,24,14,8,4,8,11,1203,18,73,1,2,0,15,932,3,24,28,2,13,8,17,22
0,0,0,5,8,0,1,17,4,6,81,3,0,0,12,0,4,0,3,0,1143,0,13,311,8,0,1,0,0,612,5,5,4,4,6,0,0,1,2,0,0,0,4,1,15,0,4,2,171,0,0,0,104,9,10,4,79,6,2,3,391,0,0,11,12,0,6,9,0,0,12,2,8,4,5,12,0,0,0,0,271,0,0,0,0,4,0,0,17,2,6,199,12,24,2,0
8,10,2,52,0,8,2,0,3,449,8,4,368,468,0,12,0,4,8,0,1,0,110,174,2,10,0,0,0,6,10,268,4,8,3,1,0,0,12,18,8,6,15,174,10,10,18,4,0,2,73,10,56,2,12,0,6,18,8,15,5,13,0,306,8,0,4,3,8,0,12,7,110,2,24,4,8,15,14,206,4,526,16,6,0,2,4,0,24,2,17,10,8,15,2,12
0,0,17,3,2,1,0,0,0,1,4,8,2,0,46,0,12,0,5,0,0,2,0,0,0,0,0,5,44,0,6,5,43,8,17,0,8,2,4,2,0,0,10,9,0,0,8,2,150,2,4,0,0,35,8,2,8,18,2,1,8,0,0,4,2,0,35,0,14,5,5,236,18,1,6,2,5,10,2,12,4,34,19,1,0,3,0,0,8,57,2,0,4,1,22,184
2,9,14,8,4,2,16,4,2,12,4,0,12,8,0,46,0,12,5,4,0,0,2,25,0,61,0,22,27,1,0,4,14,6,7,0,0,9,74,18,8,2,17,12,12,4,230,21,0,3,1,1,17,37,20,4,13,3,521,8,4,18,4,16,8,8,42,0,0,0,14,0,6,8,8,142,0,1,0,48,5,4,5,3,0,3,0,4,4,190,3,1,1,11,24,9
7,307,2,10,6,0,11,11,33,25,2,0,10,0,8,0,468,0,841,8,8,0,0,0,0,8,1,3,8,0,10,10,3,0,3,26,1,4,2,2,3,204,0,18,0,102,7,19,9,3,0,28,0,4,17,65,6,1,7,2,1,7,249,20,2,46,2,1,8,164,2,0,1046,4,14,3,3,3,16,1,0,2,1011,116,34,0,0,8,4,0,2,2,0,9,0,54
3,16,0,8,6,8,10,2,2,3,4,0,0,10,12,2,368,0,4,10,4,0,3,103,2,14,5,131,12,4,426,0,2,0,415,6,4,4,10,12,18,12,2,244,10,4,4,2,0,0,12,9,283,128,8,708,60,109,1,0,2,8,8,6,16,0,12,0,28,0,0,6,10,8,20,0,0,5,6,36,51,0,3,2,4,0,2,4,4,4,3,8,2,3,15,8
0,15,3,0,4,0,9,3,15,31,12,0,0,0,0,8,4,3,8,12,0,0,163,0,2,5,3,5,12,0,4,0,3,2,1,0,8,0,16,12,4,0,27,0,1,0,32,12,46,0,0,2,0,0,2,0,0,4,2,429,13,0,0,16,4,4,4,13,0,0,8,6,10,4,16,11,4,30,0,10,0,0,14,4,0,2110,2,1,0,4,8,4,33,0,10,8
25,0,0,0,0,4,0,31,0,239,0,12,4,2,4,4,8,81,7,107,66,11,2,38,20,4,18,8,2,4,10,2,1,7,6,23,4,2,2,10,3,944,2,2,10,4,8,1,5,13,2,7,8,8,6,0,6,0,1,5,4,2,8,14,2,0,332,4,2,6,6,6,8,6,7,54,6,2,8,4,20,6,0,40,0,0,4,58,10,4,2,12,6,4,2,2
0,67,4,0,6,13,8,523,59,0,239,31,3,25,12,1,449,6,4,8,2,2,2,2,2,1,0,2,4,0,8,7,12,2,5,214,10,3,6,2,3,4,8,57,3,0,2,12,22,2,18,6,294,0,2,3,265,0,1,18,12,0,15,0,3,14,2,0,2,30,7,10,18,4,228,8,8,6,6,6,18,3,9,0,2,26,25,8,4,8,4,0,6,12,8,6
4,22,5,1,222,8,0,6,0,59,0,15,2,33,2,0,3,4,0,3,9,0,184,5,86,2,1,0,5,4,83,2,16,0,36,0,12,0,597,4,0,30,0,81,10,3,11,8,21,0,0,31,2,0,4,10,2,6,0,4,2,1,0,2,3,20,0,8,0,29,71,12,1,0,8,5,0,11,254,9,0,4,0,0,0,4,28,2,157,4,0,8,212,4,4,3
18,2,2,16,0,0,1,0,6,523,31,3,2,11,4,0,0,17,4,542,61,0,13,0,2,0,19,4,0,0,8,0,124,1,2,1,2,4,0,5,0,54,0,0,262,5,37,1,0,1,38,0,8,2,9,37,1548,0,4,0,0,10,4,44,0,0,4,2,2,0,206,0,2,2,2,2,0,10,13,2,3,0,7,0,0,0,2,0,0,0,84,0,0,63,638,0
9,6,7,13,15,22,0,1,0,8,0,9,10,11,16,0,2,1,6,56,16,0,0,4,0,14,1,36,1,8,6,0,8,1,23,622,8,6,11,0,0,0,2,4,11,2,12,44,236,0,0,6,0,3,6,2,5,20,8,386,13,238,0,6,25,3,7,18,8,8,3,10,18,3,34,1,2,2,8,30,0,4,12,2,0,0,0,0,2,10,2,6,1,14,42,16
0,20,18,8,11,0,22,0,8,13,4,0,8,0,2,1,8,0,4,0,0,0,190,0,6,4,4,5,192,9,12,8,186,4,17,0,15,9,13,464,10,0,14,11,0,0,13,4,0,0,0,4,2,19,0,1,8,16,4,6,17,2,4,4,6,2,16,1,8,4,12,12,14,12,12,1,3,3,0,4,382,0,10,0,2,0,0,12,4,2,2,1,6,16,12,10
368,22,100,4,0,11,15,0,222,6,0,4,6,6,4,2,0,8,8,8,0,135,1,0,0,17,3,10,138,8,881,4,7,8,4,6,2,6,7,9,12,318,12,15,5,7,7,2,12,12,39,2,10,371,2,1,4,24,2,4,15,2,23,12,297,780,190,8,15,2,41,21,9,7,12,5,13,88,1,878,2,10,12,9,0,6,3,549,84,18,0,0,2,5,3,2
2,0,2,0,4,8,13,16,1,0,0,0,8,10,8,3,52,5,9,5,12,0,2,2,7,18,23,2,7,12,15,4,11,2,12,0,2,0,10,17,8,414,2,0,4,1,14,10,4,2,2,2,4,744,2,25,4,4,1,3,439,12,41,2,1,509,0,3,0,2,12,10,16,21,12,2,8,4,2,4,2,0,12,2,0,1,7,3,8,9,3,12,8,2,10,14
2,8,0,2,100,18,7,2,5,4,0,3,0,2,14,17,2,0,13,12,8,4,8,11,1,5,0,5,6,9,13,4,2,20,7,372,12,2,30,6,12,6,24,6,2,29,60,16,0,5,2,15,4,26,36,2,0,16,6,9,16,16,0,4,3,11,12,17,2,592,20,6,16,779,200,14,5,10,10,8,14,55,18,942,12,0,4,11,10,0,14,3,10,13,4,9
2,0,8,0,22,20,6,2,22,67,0,15,16,307,9,0,10,0,8,0,0,0,0,9,2,6,2,14,0,2,15,104,128,0,8,177,8,1,87,0,6,6,6,4,4,16,0,134,80,9,34,0,10,13,0,12,3,8,18,4,4,5,0,4,201,0,3,45,0,610,5,9,6,1,6,2,8,31,43,1,0,6,0,4,0,58,0,0,2,12,0,0,164,2,4,202
0,2,2,2,368,0,9,18,4,0,25,0,3,7,2,0,8,0,5,3,0,0,0,0,4,2,0,0,2,2,0,0,117,0,2,9,0,0,0,0,0,1,2,0,46,2,2,0,0,1,0,1,2,34,2,0,26,2,2,0,0,0,8,8,423,0,31,4,0,0,3,0,2,0,3,5,0,1270,103,84,0,1,0,5,0,0,0,5,0,2,8,0,0,7,2,4
